wilderness	n. 荒野, 荒地
responsible	adj. 有责任的,负责的,责任重大的,应负责的
personnel	n.全体员工； （与复数动词连用）人员，员工； 人事部门
desperate	adj. 不顾一切的,绝望的, 极想得到的
lethal	adj. 致命的,毁灭性的,有效的 n. 基因异常,致死基因
destination	n. 目的地,终点,景点
restrict	v. 限制,约束
phase	n. 相, 相位,时期,局面,阶段 v. 逐步执行,实行,按计划进行
dominate	v. 支配, 占优势，俯视
nominal	adj. 名义上的,有名无实的,名词性的 n. 名词词组
device	n. 装置, 设计, 策略, 设备
devote	vt. 投入于,献身
motor	adj. 机动的,有引擎的，汽车的 n. 发动机,马达，汽车 vt. & vi. （用引擎）驱动
eccentric	n. 怪人 adj. 古怪的, 反常的
indignant	adj. 愤慨的, 愤愤不平的
referral	n. 送交，转送，转诊病人
ecology	n. 生态学
civilisation	n. 文明，文化，教化 =civilization（美）
disposal	n. 处理,消除,销毁,处置 n. 弃菜碾碎器
editorial	n. 社论 adj. 编辑的
hypothetical	adj. 假设的, 假定的, 爱猜想的
symbolism	n. 象征主义, 象征, 符号化
menace	n. 威胁, 胁迫 v. 威吓, 胁迫
habitat	n. (动植物的)产地,栖息地
interrupt	n. 中断 vt. 打断,妨碍 vi. 插嘴 [计算机] 中断
plain	n. 平原,草原 adj. 简单的,平坦的,平常的,家常的 adj.纯的，不掺杂的
disdain	n. 轻蔑 v. 蔑视
advocate	vt.提倡； 拥护； 鼓吹； 为…辩护 n.（辩护）律师； 提倡者； 支持者
lack	vt.缺乏，缺少； 需要的东西 n.缺乏，不足，没有； 缺少的东西
demanding	adj. 要求多的, 吃力的
furtive	adj. 偷偷的
financial	adj. 金融的,财政的
institutional	adj. 制度上的，惯例的，机构的
discard	n. 丢牌,废牌 vt. 丢弃,抛弃 vi. 丢牌
estate	n. 财产,房地产,状态,遗产
modification	n. 修正, 修饰, 修改
exceptional	adj. 例外的,异常的,特别的
transparent	adj. 透明的, 明显的, 清晰的
synthesis	n. 合成,综合,推理
equivalent	adj. 等价的, 相等的 n. 相等物
magnetism	n. 磁性, 吸引力, 磁学
appreciation	n. 赏识, 鉴识, 感激
distribute	vt. &vi. 分配,散布
trial	n.试验； [法]审讯，审判； 磨难，困难； [体]选拔赛 adj.试验的； [法]审讯的
regularize	v. 使有规则, 使有秩序, 调整
threatening	adj. 威胁(性)的, 凶兆的 动词threaten的现在分词
statement	n. 声明, 陈述
struggle	n. 竞争,努力,奋斗 v. 努力,奋斗,挣扎
flow	vi.流； 垂； 流出； （谈话、文体等）流畅 n.流动； 滔滔不绝； 涨潮； 连贯 vt.使泛滥； 淹没； 排出
absence	n. 没有；缺乏；缺席；不注意
continue	vt. &vi. 继续, 连续, 维持
steady	adj. 稳定的,稳固的,沉稳的 adv. 平稳地,稳固地 n. 固定的事物 vi. &vt. (使)稳固,(使)稳定
repute	n. 名望, 名气, 声望 vt. 认为, 以为
processor	n. 加工者,处理器
provisional	adj. 暂时的 n. 临时性,临时人员
humanist	n. 人类学者,人道主义者,人文学者
stimulate	vt. 刺激,激励,鼓舞 vi. 起刺激作用
diversity	n. 多样化，（人在种族、民族、宗教等方面的）多样性； 差异； 分歧 vt. 使不同,使多样化
implausible	adj. 难信的, 不像真实的
demoralize	vt. 使士气低落, 使失去斗志
force	n. 力量,武力,暴力,影响力 vt. 施暴,强迫,强夺,加压力 [计算机] 强制
satisfy	vt. 使...满意, 使...信服 vi. 足够, 取悦
terminator	n. 终结者，（月球等的）明暗界限
license	n. 批准,许可证,特许 vt. 允许,特许
ordeal	n. 严酷的考验，痛苦的经验，神裁法
impartial	adj. 公平的, 不偏不倚的
exterior	n. 外部, 表面, 外型 adj. 外部的, 外在的, 表面的 [计算机] 外部的
scale	n. 鳞, 刻度, 衡量, 数值范围 v. 依比例决定, 攀登
entirely	adv. 完全地
imagination	n. 想象,想象力,空想
scholar	n. 学者，获奖学金的学生
erode	vt. 腐蚀,侵蚀 vi. 受到侵蚀
toxic	adj. 有毒的 n. 有毒物质
commission	n. 委任(状), 任官令; 委员会 n. 佣金; 犯罪行为 vt. 委任, 委托; 使服役
rejection	n. 拒绝, 被弃, 被抛弃的实例
coordinator	n. 协调者,同等的人或物 [计算机] 协调程序
patron	n. 赞助人, 保护人, 老主顾
substance	n. 物质,实质,内容,重要性,财产
occasion	n. 场合,机会,理由 vt. 致使,惹起,引起
occupy	vt. 占领,占,住进
occur	vi.发生； 出现； 闪现
frighten	v. 使惊吓, 惊恐
elicit	vt. 引出,诱探出
periodic	adj. 周期的, 定期的，间歇的，完句的
blame	n. 过失,责备 vt.把...归咎于,责备
arrange	vt. 安排,整理,计划,改编(乐曲) vi. 协商,计划
arrangement	n. 安排,商议,整理
ecosystem	n. 生态系统
injure	v. 伤害, 使...受冤屈
volunteer	n. 志愿者,自行生长的植物 adj. 志愿的,自行生长的(树等) vt. &vi. 自愿(做)
concern	vt. 涉及, 影响, 关心 n. 关心, 忧虑, 关心的事; 公司, 企业
contrary	adj. 相反的,截然不同的 adv. 相反(地) n. 反面,相反
continuity	n. 连续性
warrant	n. 正当理由,根据,委任状,准许 vt. 保证,辩解,担保, 授权
skepticism	n. 怀疑论, 怀疑态度, 怀疑主义
supreme	adj. 最高的, 至上的, 极度的
digress	v. 走向岔道, 离开本题, 扯到枝节上
absorb	v. 吸收,吸引...的注意,使全神贯注
ponder	vt. &vi. 沉思,考虑
abundant	adj. 丰富的,充裕的
consent	n. 同意, 许可 v. 同意, 承诺
astronomer	n. 天文学家
sustain	vt. 承受, 支持, 经受, 维持
rationality	n. 理性，合理性 （复数）rationalities:合理的意见（信仰、行为等）
benign	adj. 仁慈的,温和的,良性的
perceptive	adj. 知觉的, 有洞察力的, 感知的
adaption	n. 由原著改编而成的作品 =adaptation
security	n.安全； 保证，担保； 保护，防护； 有价证券 adj.安全的，保安的，保密的
unity	n. 个体, 一致, 结合
producer	n. 生产者, 制片人
corruption	n. 腐败, 堕落, 贪污
machinery	n. (总称)机器, 机械
puzzle	n. 难题,迷惑 vt. 使困惑,解决 vi. 迷惑,苦思
concurrent	adj. 同时发生的
blatant	adj. 喧嚣的,吵闹的,俗丽的,明目张胆的
plagiarism	n. 剽窃,剽窃物
opponent	n. 对手, 敌手, 反对者 adj. 敌对的, 反对的
opportunity	n. 机会, 时机
major	n. 主修, 成年人, 陆军少校; 巨头 adj. 主要的, 较多的, 大部份的 vi. 主修
endure	vt. 忍耐,容忍 vi. 持久,持续
quote	n. 引用 v. 引述, 举证, 报价
enigma	n. 费解的事情，谜，谜一般的人
correspond	vi. 符合,通信,相当
qualitative	adj. 性质上的, 质的, 定性的
questionable	adj. 可疑的, 可置疑的
enrolment	n. 登记,招收，入学
inspirational	adj. 带有灵感的, 给予灵感的, 灵感的
original	adj. 最初的, 原始的; 有独创性的, 原版的 n. 原件, 原稿; 有独创性的人, 怪人
ignorance	n. 无知
comparable	adj. 可比较的, 比得上的
phenomenal	adj. 现象的, 可感知的, 非凡的
equipment	n. 设备,装备
scanner	n. 扫描机, 扫描仪
infer	vt. 推断,猜测,暗示 vi. 推论
alternative	adj. 两者择一的; 供选择的; 非主流的 n. 替换物, 取舍
covert	adj. 隐蔽的, 偷偷摸摸的, 隐密的n. 藉口, 树丛, 蔽覆羽翮基部的羽毛
reconcile	vt. 和解,调和,妥协 vi. 调和
accounting	n. 会计
domination	n. 支配, 控制, 管辖 （复数）dominations:[宗]主天使
commonwealth	n. 共和国,联邦
ingenious	adj. 机灵的,精制的,有独创性的
weaken	v. 使...弱, 变弱, 弄淡
wealth	n. 财产,财富,大量,丰富
reaction	n. 反应,反作用力,化学反应
rehabilitate	vt. 改造, 使康复, 使恢复（名誉等）
disruptive	adj. 捣乱的, 破坏性的, 制造混乱的
incidence	n. 发生(率),入射
technical	adj. 工艺的, 技术的
remorse	n. 懊悔,悔恨 n.
consistency	n. 坚持, 一致性, 强度, 硬度, 浓稠度
engage	v. 答应, 预定, 使忙碌, 雇佣, 订婚
herbal	adj. 草药的
cultivate	vt. 培养,耕作,栽培,结交(朋友), 促进增长, 教养
instruct	v. 教, 命令, 指导 [计算机] 指示
reprisal	n. 报复, 报仇, 报复性劫掠
administrative	adj. 行政的,管理的
suppose	vt.假定； 猜想，推测； 认为； 让（用于祈祷语气） vi.想象，猜想
infamous	adj. 无耻的,不名誉的,声名狼藉的
refuse	n.废物,垃圾 vt. &vi. 拒绝 adj. 无用的
measure	n. 措施, 办法, 量度, 尺寸 v. 测量, 量
calculate	vt. 计算,估计,考虑,推测 vi. 计算,预测,依赖
regardless	adj. 不注意的, 粗心的 adv. 不顾
expert	adj. 熟练的,内行的 n. 专家,能手 vi. 当专家
exclaim	v. 大叫, 呼喊, 大声叫
greeting	n. 问候,打招呼
melt	n. 熔化,熔化物 vt. &vi. 熔化,溶解, 软化, 渐渐混合
campaign	n. 战役; 运动, 活动 vt. 参加竞赛 vi. (从事, 组织)活动
theoretical	adj. 理论上的
explode	vt. 爆炸,驳倒 vi. 爆炸,爆发(感情)，激增 [计算机] 爆炸
sensor	n. 传感器，探测器
mental	adj. 精神的,脑力的,精神错乱的,传心术的,[解剖学]颏的
unstable	adj. 不稳定的，易变的
irregular	n. 不合规格之物 adj. 不规则的, 不整齐的, 不合法的
intrinsic	adj. 固有的, 内在的
remedy	n. 药物,治疗法,补救 vt. 治疗,补救,矫正
deprive	vt. 剥夺,拒绝,免职
withdraw	vt. 撤回,取回,撤退 vi. 退回,撤退
pattern	n. 图案, 式样, 典范 v. 以图案装饰; 仿造, 模仿
decrease	n. 减少(量),降低 vt.& vi. 减少,降低
regime	n. 政权，政体；社会制度；管理体制
faculty	n.能力，才能； 全体教职员； <英>（大学的）专科，系； 特权，特许
regard	vt.认为； 注视； 涉及； 尊敬 vi.凝视； 留意 n.凝视； 留意； 尊敬； 问候
expertise	n. 专家的意见,专门技术
neighbouring	adj. 接壤的, 邻近的 动词neighbour的现在分词形式 =neighboring(美)
define	vt. 定义, 解释
utter	adj. 全然的,绝对,完全 vt. &vi. 发出,作声,发表
finitude	n. 有限，限定
inhibition	n. 禁止, 禁制, 压抑
delete	vt. 删除
nostalgia	n. 乡愁, 向往过去, 怀旧之情
distort	vt. 变形,扭曲,歪曲 vi. 歪曲
afflict	vt. 使苦恼,折磨
allude	vi. 暗示,暗指
disrupt	adj. 分裂的,分散的 v. 使...分裂,使...瓦解
mechanical	adj. 机械的,力学的,呆板的    n.(供制版用的)样书, 版面设计
projectile	n. 发射体, 抛射物 adj. 发射的, 投射的
linger	vt. 消磨, 无所事事 vi. 逗留,消磨,徘徊,漫步
gist	n. 要点, 要旨
modest	adj. 谦虚的, 适度的, 端庄的
identification	n. 身份的证明 n. 视为同一,证明同一,确认
aloof	adj. 疏远的,冷淡的 adv. 远离,离开
responsibility	n. 责任, 可信度，责任心
fatal	adj. 致命的, 毁灭性的, 决定性的
restrain	vt. 抑制,阻止,束缚,剥夺
documentary	adj. 文献的 n. 纪录片
phenomenon	n. 现象, 非凡的人或事物
deterrent	adj. 制止, 防止, 挽留 n. 挽留的事物, 妨碍物
sabotage	n. 怠工,破坏活动,破坏 vt. 从事破坏活动,妨害,破坏
evolutionary	adj. 发展的(展开的,调优的)
devise	vt. 设计,遗赠 n. 遗赠(的财产)
aggravate	vt. 使...恶化,使...更严重 vt. [口]激怒
lien	n. 扣押权, 留置权
atmospheric	adj. 大气的，大气层的，制造气氛的
suffering	n. 痛苦,受难
feedback	n. 反馈,成果
configuration	n. 结构,布局,形态,格式塔心理完形 [计算机] 配置
dictate	vi. 听写 vt. 口述,口授 n. 命令,指挥,指令
appease	v. 安抚, 缓和, 平息，姑息
absorption	n. 吸收,全神贯注
malicious	adj. 怀恶意的, 恶毒的
identity	n. 身份,一致，特征
acknowledge	vt. 承认,公认,告知收到,表示感谢,注意到
tour	n. 旅游, 观光旅行, 任期 v. 旅行, 周游
figure	n. 图形, 数字, 形状; 人物, 外形, 体型 v. 演算, 认为, 领会到
towel	n. 毛巾 v. 用毛巾擦 vt. 用毛巾擦或擦干
label	n.标签； 称标记，符号； [建] 门或窗户上面的线脚 vt.贴标签于； 把…称为； 把…列为； [化]用放射性元素使（元素或原子等）示踪
avid	adj. 渴望的,贪婪的,热心的
manipulate	v. 操纵,利用,假造 [计算机] 操作
subtle	adj. 微妙的,敏感的,精细的,狡诈的,不明显的
plate	n. 碟,盘,金属板,板块 vt. 镀金,电镀,为...制印版,, 给...装钢板,用金属板固定
negative	adj. 否定的,负的,消极的 n. 底片，负数，否定 vt. 否定
allowance	n. 限额，定量 n. 津贴,零用钱
acquisition	n.获得； 购置物； 获得物； 收购
circle	n. 圆周,社交圈,循环 vt. &vi. 包围,盘旋,环绕
amateur	adj. 业余(爱好者)的 n. 业余爱好者,外行
multimedia	adj. 多媒体的 n. 多媒体
favourable	adj. 有用的, 良好的, 赞成的
miserly	adj. 吝啬的
disgust	n. 厌恶,嫌恶 vt. &vi. 令人厌恶
revolutionise	v. （使）发生革命性剧变 =revolutionize(美)
precede	vt. &vi. 在...之前,优于,较...优先
rotate	vt. &vi. (使)旋转,轮流 adj. 车轮状的
underestimate	n. 低估 v. 低估
particular	n. 个别项目, 详细说明 adj. 特别的, 独有的; 挑剔的; 详细的
prone	adj. 俯卧的, 易于...的, 有...倾向的
democracy	n. 民主,民主制,民主国家
excerpt	n. 摘录 v. 摘录,摘要 vt. 摘,引用
evade	v. 规避, 逃避, 躲避
division	n. 区分,分开,除法,公司,部门，师（军队里）
pop	n. 取出,砰然声,流行乐曲,流行文化艺术,（尤用作称呼）爸 adj. 流行的,热门的,通俗的 vt. 取出,发出爆裂声,突然伸出,击打,开火 vi. 发出砰的一声，（因激动、惊奇）张大 adv. 突然间地, 暴发地 POP abbr.=point of purchase POP abbr.=population 人口
consultant	n. 顾问, 咨询专家
altruistic	adj. 利他主义的, 无私的
deficit	n. 赤字,不足，缺乏
curriculum	n. 课程，全部课程
affiliate	n. 联号(联播台,同伙),附属机构,分公司 vt. &vi. 合并(使...加入,追源)
pursue	v. 追捕, 追求, 继续从事
forfeit	n. 没收物,罚金,丧失 vt. 没收,丧失 adj. 丧失了的
humanistic	adj. 人文主义的, 人本主义的, 人道主义的
formality	n. 礼节,程序,拘谨
formative	adj. 形成的, 造形的，影响发展的 n. 造字要素
fantasy	n. 幻想 v. 幻想
comedian	n. n. 喜剧演员
founder	n. 创立者, 建立者 v. 摔倒, 失败，沉没，弄跛
domain	n. 领域 [计算机] 域
preliminary	n. 初步行动, 准备, 初步措施 adj. 初步的, 开始的, 预备的
guidebook	n. 旅行指南，参考手册
orient	adj. [诗]东方的,闪闪发光的 n. 东方,珍珠,东方国家 vt. 使向东,确定方向,定位,以...为参照,使熟悉或适应 vi. 转向东方
present	n. 礼物, 现在 adj. 当面的, 出席的, 现在的 v. 赠送, 提出, 呈现
liberty	n. 自由；许可；冒失
flagrant	adj.臭名远扬的； 恶名昭著的； 明目张胆的
enquire	=inquire v. 询问, 调查
antidote	n. 解毒剂, 解药 n.(喻)矫正方法
inheritance	n. 遗传,遗产,继承,继承物
partner	n. 合作者,搭档,配偶 vt. &vi. 同...合作,做...的搭档, 合作
structure	n. 结构,构造,建筑物 v. 构成,建立,建造
observation	n. 观察,观察力,评论 adj. 被设计用来观察的
fragment	n. 碎片 vt. &vi. 变成碎片 [计算机] 碎片
mammal	n. 哺乳动物
transcend	v. 超越
obey	vt. &vi. 服从,听从
bewilder	vt. 使迷惑，使...不知所措
maximize	v. 取...最大值,最佳化 [计算机] 最大化
submit	vt. 呈送, 递交, 主张 vt. 使服从, 屈服 vi. 屈从; 忍受
obstacle	n. 障碍,绊脚石
obtain	vt. 获得, 得到 vi. 通用, 流行, 存在
capitalist	n. 资本家，资本主义者 adj. 资本主义的，有资本的
occupation	n. 职业
success	n. 成功,发财，胜利，成功者，成功的事物
approve	vt. 批准,核准,证实 vi. 赞同
obedient	adj. 服从的, 顺从的
during	prep. 在...期间
specially	adv. 特别地, 专门地
recognise	v. 承认, 识别, 认可
preventable	adj. 可防止的，可预防的
suit	n. 套装, 诉讼, 请求 v. 适合, 取悦, 满足
trajectory	n. 轨道,弹道,轨线
summary	n. 摘要,概要 adj. 摘要的,简略的
secrecy	n. 秘密，保密, 隐蔽
metaphor	n. 隐喻,暗喻
warehouse	n. 仓库 vt. 存入仓库
superficial	adj. 表面的,肤浅的
bold	adj. 大胆的,粗体的,醒目的，无礼的,陡峭的
apathy	n. 缺乏感情或兴趣,冷漠
abandon	n. 放纵 vt. 放弃,遗弃,沉溺
renaissance	n. 文艺复兴,再生
humor	n. 幽默,诙谐,心情 v. 迎合,牵就,顺应
circumscribe	vt. 在...周围画线, 限制
academic	n. 教学人员,学术人员 adj. 学院的,理论的,学术性的
boundary	n. 分界线, 边界
negotiation	n. 谈判, 协商
vary	vt. 改变,使多样化 vi. 变化,违背
tedious	adj. 沉闷的, 单调乏味的
malign	adj. 有害的, 恶性的, 有恶意的 vt. 诽谤, 说坏话
accuse	vt. 责备,控告
verify	v. 查证,核实 n.[计算机] DOS命令 : 打开关闭在 DOS操作期间的写文件校验开关
switch	n. 开关, 电门，闸，转换器, vt. &vi. 鞭打，转轨，交换，突然转变, 摆动，接通或切断…电流
setting	n.镶嵌； 环境； 装置； （某事、戏剧、小说等的）背景 v.放( set的现在分词)； 安插； 树立； 安排
corpus	n. [计] 语料库；文集；本金
embrace	n. 拥抱 v. 拥抱,互相拥抱,包含
settlement	[建]沉降; 解决, 结算,殖民(地), 租界; 居留地; 新建区; 住宅区
contrast	n.对比，对照； 差异； 对照物，对立面； [摄]反差
employ	vt. 使用, 雇用, 使忙于 n. 使用, 雇用
quantity	n. 量,数量,大量
brief	n. 摘要,简报,公事包 adj. 简短的,简洁的 v. 对...作简报,摘要
counselor	n. 顾问, 参事, 法律顾问
operation	n. 手术, 行动，活动, 操作
shallow	adj. 浅的, 肤浅的, 浅显易懂的 n. (pl.)浅滩, 浅处 v. 变浅
majority	n.多数； （获胜的）票数； 成年； 法定年龄
infant	adj. 婴儿的, 幼稚的, 初期的 n. 婴儿, 幼儿
coincide	v. 与...一致,符合,暗合
shell	n. 贝壳,壳,外形 vt. &vi. 去壳,脱落,炮击,拾贝壳 n.[计算机] DOS命令 : 安装备用的COMMAND.COM文件, 并改变环境尺寸
aggressive	adj. 侵略性的；好斗的；有进取心的；有闯劲的
announcement	n. 公告,发表,告知
humanity	n. 人类 人性;人道;慈爱
optimist	n. 乐观主义者
ensure	vt. 确定,保证,担保
nullify	v. 使无效, 废弃, 取消
flop	n. 砰然落下, 失败 v. 笨重的摔, 猛落, 笨拙地抛下 adv. 噗通的摔
distressed	adj.痛苦的  动词distress的过去式和过去分词
regenerate	vt. 再生(回收,革新) adj. 再生的(更新的,革新的)
bland	adj. 乏味的；温和的；冷漠的 vt. 使…变得淡而无味；除掉…的特性 vi. 变得平淡无奇；丧失特性
impulse	n. 冲动, 驱动力, 倾向, 心血来潮 vt. 推动
composer	n.创作者（尤指乐曲的）
mediate	adj. 居间的,间接的 vt.& vi. 斡旋,调停
transition	n. 过渡,转变
confidential	adj. 机密的,获他人信赖的,易于信任他人的
button	n. 钮扣,徽章,像纽扣的东西,未成熟的蘑菇,按钮 vt. 用纽扣装饰,钉纽扣,闭嘴 vi. 扣上
signal	n. 信号,导火线,动机 vt. 发信号,标志 vi. 发信号 adj. 显著的
poverty	n. 贫穷,贫困
reproduction	n. 再现, 复制, 生殖，幼树
insect	n. 昆虫
silly	adj. 愚蠢的,淳朴的,晕的
impulsive	adj. 冲动的, 受感情驱使的, 任性的
statistics	n. 统计；统计学；[统计] 统计资料
seldom	adv. 很少 adj. 很少的
delightful	adj. 令人愉快的, 可喜的
temperature	n. 温度,发烧
syndrome	n. 综合征，综合症状；（不良情况的）典型表现，典型行为
except	vt. 除,除外 prep.&conj. 除了...之外,若不是,除非
intend	v. 打算 vt. 想要,打算,计划
reference	n. 参考, 出处, 参照 n. 推荐人, 推荐函 vt. 提供参考
inject	v. 注射
grammatical	adj. 语法的, 合乎文法的
exclude	vt. 除外,排除,拒绝 [计算机] 排除
nutrition	n. 营养
excuse	n. 借口,理由；低劣的样品,假条 vt. 原谅,辩解,准许离开,同意赦免
interference	n. 冲突, 干涉 [计算机] 干涉
intermediate	adj. 中级的,中间的 n. 中间体,媒介物, 调解人 vi. 调解, 干涉
inflict	vt. 施以,加害,使遭受, 折磨
grasp	n. 把握,抓紧,领会  vt. 抓住,紧握,领会
scholarly	adj. 学究气的，学者派头的 名词scholar的形容词
interpretation	n. 解释,演出,翻译,互動
propel	v. 推进, 驱使
stereotype	n. 铅版,陈腔滥调,老一套 vt. 使用铅版,套用老套
susceptible	n. 易受影响者,易受感染者 adj. 易受影响的,易感动的,容许
discipline	n. 训练, 纪律, 惩罚; 学科 vt. 训练, 惩罚
agnostic	n. 不可知论者 adj. 不可知论的，不可知论者的
investment	n. 投资,投入,投资额
exploit	n. 功绩,勋绩 vt.&vi. 开发,利用,开拓
irrigation	n. 灌溉
external	n. 外部 adj. 外部的,外用的,客观的,表面的
deceive	vt. 欺骗 vi. 行骗
signature	n. 签署,书帖,有特征的符号
allergy	n. 敏感症,反感,厌恶
oscillation	n. 振动, 动摇, 彷徨，振幅，单一的振动循环
aspect	n. 方面, 外貌, 外观; 方位, 方向
flooding	n. 泛滥, [医]产后出血 adj. 泛滥的 动词flood的现在分词形式
adamant	adj. 非常坚硬的，强硬的，固执的 n. 坚硬无比之物，硬石
assure	vt. 保险,保证,确信,担保
definite	adj. 明确的,一定的
university	n. 大学
sole	adj. 唯一的, 独占的 n. 脚底, 鞋底; sole 或soles 鳎鱼 vt. 给(鞋)换底
directory	n. 目录,工商名录,指南 [计算机] 目录 adj. 给予指导的
depart	vt. 离开 vi. 离开,死亡,脱轨
disperse	vt. 分散,传播,散开 vi. 分散
resource	n. 资源,谋略,消遣
allergic	adj. 过敏的,反感的
divulge	v. 泄露, 暴露
description	n. 描写, 描述, 说明书, 作图 n. 类型
harsh	adj. 粗糙的, 使人不舒服的，刺耳的, 严厉的，大约的
lobby	n. 大厅, 门廊, 门厅, 休息室, 游说议员者 v. 游说
locality	n. 地区，位置，地点，发生地
desire	n. 愿望, 欲望, 情欲 v. 向往, 要求, 请求 vt. 渴望
personal	adj. 私人的,个人的 n. (报刊的)私人专栏
monitor	n. 监督器, 班长, 监听员, [计算机]显示器, 监视器 v. 监视, 监听, 监督
broadband	n.宽频带, 宽带 adj.宽频带的
mood	n. 心情, 情绪, 语气
activate	v. 刺激,使...活动,创设
prevail	vi. 获胜, 盛行, 主导
administer	vt. 管理,执行,给与 vi. 执行管理人职责,给与帮助
phrase	n. 短语,习语,个人风格,乐句 vt. 措词表达,将(乐曲)分成乐句(来演奏)
longevity	n. 长寿
motive	adj. 发动的,运动的,积极的,动机的 n. 动机, 主题 vt. 促使, 使有动机
flaunt	v. 挥动, 夸耀, （厚颜无耻地）炫耀, 飘扬，张扬
revolutionary	adj. 革命的 n. 革命者
toughen	v. 使...坚韧, 使...顽固
fiction	n. 小说,虚构
apprehensive	adj. 惴惴不安的,敏悟的,有知觉的
operative	adj. 有效的, 至关重要的, 操作的，手术的 n. 技工，侦探
fierce	adj. 猛烈的, 凶猛的, 残暴的, 强烈的
automobile	n. 汽车 adj. 汽车的
available	adj. 可用的,可得到的,有用的，有效的
insight	n. 洞察力
conversion	n. 转变, 改变信仰, 换位
direct	adj. 笔直的,直接的,坦白的 vt. 指挥，命令，负责 vi. 指导，指出
auction	n. 拍卖 vt. 拍卖
finance	n. 财政, 资金 vt. 给...提供资金, 负担经费
menial	adj. 适合仆人做的, 卑微的 n. 佣人，家仆，卑贱的人
foresight	n. 远见, 深谋远虑
immediacy	n. 直接，目前，密接，及时性，紧迫性
bargain	n. 交易,买卖,物美价廉的东西 vi. 议价 vt. 议价交易
launcher	n. 发射者，发射物，发射台
surpass	vt. 超越,凌驾,胜过
absorbing	adj. 吸引人的, 非常有趣的 动词absorb的现在分词
neighbour	n. 邻居(邻近的东西, 邻近值) vt 邻接(相邻, 接近)
authentic	adj. 可靠的,可信的,真的,真正的
relatively	adv. 比较地, 相对地
disorder	n. 杂乱,混乱 vt. 扰乱
clarify	vt. 澄清,阐明,使...明晰
police	adj. 警察的 n. 警察,警方 v. 管辖
motorway	n. (英）高速公路
explicit	adj. 明确的,详述的，明晰的,外在的
floppy	adj. 叭塌叭塌响的,懒散的,邋遢的
magnitude	n.巨大，广大； 重大，重要； 量级； （地震）级数
preventative	adj. 预防性的 n. 预防法
neutral	adj. 中立的,中性的 n. 中立者,空挡的,素净色
succumb	v. 屈从, 死
embed	vt. 栽种，使嵌入，使深留脑中
leading	n. 领导, 疏导, 铅板 adj. 领导的, 主要的, 在前的 vbl. 领导, 引领, 以铅接合 [计算机] 行间空白
portion	n. 部分,份,命运 v. 将...分配,分配
absent	adj. 缺席的,缺少的 vt. 使缺席
tract	n. 广阔的土地,地域,器官系统,宣传小册子
benefactor	n. 恩人, 捐助者, 赠送者
composite	adj. 合成的,复合的 n. 合成物, 复合材料 vt. 合成
believable	adj. 可相信的
demonstration	n. 示范,实证,表达,集会
dependence	n. 依赖, 信赖，上瘾
thermostat	n. 恒温器
climate	n. 气候, 风气, 气氛
informant	n. 通知者, 密告者 n. 为语言研究提供资料的人
adventure	n. 冒险,奇遇 vt. 冒险,尝试 vi. 大胆进行,冒险
precise	adj. 精确的,准确的,认真的
precision	n. 精确,精密度 adj. 以精准的执行而著称的, 经得起极精细测量的
retaliate	v. 报复, 报仇, 回敬
audio	adj. 成音频率的,声音的 n. 音响设备
dubious	adj. 怀疑的,可疑的
periodical	n. 期刊 adj. 周期的, 定期的
probable	adj. 很可能的 n. 很可能的事
drawer	n. 抽屉
illustrate	vt. 举例说明,作图解 vi. 举例
fossil	adj. 化石的 n. 化石,食古不化的人,过时的词
epidemic	n. 传染病, 流行病 adj. 流行的, 传染性的
foundation	n. 基础；地基；基金会；根据；创立
pacify	vt. 使...平静, 安慰
unpredictable	adj. 不可预知的
fume	n. 臭气, 烟, 激怒 v. 熏, 冒烟
comment	n. 注释, 评论; 闲话 v. 注释, 评论
impossible	adj. 不可能的
vegetative	adj. 植物生长的，植物人状态的
objection	n. 反对,异议
probably	adv. 大概,或许
anxious	adj. 焦急的, 忧虑的
participation	n. 参加, 参与
peer	vi. 凝视，盯着看；窥视 vt. 封为贵族；与…同等 n. 贵族；同等的人
occasionally	adv. 偶尔地
durable	adj. 耐用持久的 n. (复)耐用品
complicate	vt. 弄复杂, 使错综, 使起纠纷
dust	n. 灰尘,无价值之物,屈辱状态 vt. 拂去灰尘, 撒上粉状物体,大胜 vi. 擦拭灰尘
prompt	adj. 迅速的, 敏捷的, 立刻的 vt. 激起, 促进, 推动; 提示 vi. 提示 n. 提示; 提示的内容 n. [商]付款期限
improvise	v. 即席写作,即席即兴,即席而作
compel	v. 强迫,迫使
requisite	adj. 必要的, 需要的 n. 必需品
fund	n.基金； 储备； 现款； 特别基金管理机构 vt.积存； 为…提供资金； 提供资金偿付（债款等）的本息； 把（短期借款）转为有固定利息的长期借款
association	n. 联合,结合,交往,协会,社团,联想
numerous	adj. 为数众多的,许多
inventive	adj. 善于创造的, 发明的
concrete	n. 水泥,混凝土 adj. 具体的,实在的,水泥的 vt. &vi. 凝结,结合
ancestral	adj. 祖先的, 祖传的
variability	n. 易变, 变化性, 变异性
effective	adj. 有效的,有影响的
photocopier	n. 复印机
valid	adj. 有确实根据的; 有效的; 正当的, 合法的
surrender	vt. &vi. 投降,让与,屈服 n. 投降,屈服,放弃
inspire	vt. 影响，使...感动, 激发，煽动 vi. 吸入
consequence	n. 结果,后果
detach	vt. 使分离, 拆卸 [计算机] 脱离
accompany	vt. 陪伴, 伴随，给...伴奏 vi. 伴奏
considerable	adj. 相当大的,可观的,重要的
prediction	n. 预言, 预报
consideration	n. 考虑, 体贴, 考虑因素, 敬重, 意见
accumulate	vt. 积聚,累加,堆积 vi. 累积
electron	n. 电子
element	n. 成分,要素,元素,基本原理,(复数)恶劣天气
gesture	n. 手势,姿态 vt.& vi. 作手势表达
contempt	n. 轻视,轻蔑
automation	n. 自动化
announce	vi.宣布参加竞选； 当播音员 vt.宣布； 述说； 声称； 预告
continual	adj. 不断的, 频繁的
sympathize	v. 同情, 同感
fan	n. 风扇,扇形物,狂热者 vt. 风选,煽,吹,煽动,向扇子一样展开 vi. 像扇子一样行动,鱼贯而出
contribute	vt. 捐助,投稿 vi. 投稿,贡献,是原因之一
cite	vt. 引用,引证,传讯,嘉奖
violent	adj. 暴力的,猛烈的,极端的,曲解的
obscure	adj. 微暗的,难解的,不著名的,[语音学]轻音的  vt. 使...阴暗,隐藏,使...含糊,成为含糊的元音   n. 暗淡,模糊
client	n.顾客； 当事人； 诉讼委托人； [计算机]客户端
convince	vt. 说服, 使...相信
conceal	vt. 隐藏, 掩盖
maintenance	n. 维护, 保持, 维修, 生活费用 n. 供给, 抚养; 主张
incident	n. 事件,（常指）军事冲突, 插曲，事变 adj. 难免的，附带的，(物理)入射的
recycle	vt. 使再循环,再利用,再制 vi. 循环 n. 再循环
elaborate	adj. 精细的, 详尽的, 精心的 v. 详细地说明, 用心地作, 推敲
compile	v. 编译,编辑,编纂 [计算机] 编译
comedy	n. 喜剧,滑稽, 幽默事件
theorist	n. 理论家
illuminate	vt. 照明,阐释,说明
compatible	adj. 能共处的,可并立的,适合的, 兼容的 n. 兼容
bundle	n. 捆,束,一批,一大笔钱 vt. 捆,匆匆送走,附赠 vi. 匆忙
aspire	vi. 渴望；立志；追求
alleged	adj. 被说成的，声称的，有嫌疑的
comply	vi. 顺从,答应
information	n. 信息, 情报, 新闻, 资料, 询问
recur	v. 回到, 重现, 再来
inherit	vi. 继承 vt. 继承,遗传
reader	n. 读者，读物, 读本
ironic	adj. 说反话的, 讽刺的
significance	n. 意义,重要性
inquiry	n. 打听, 询问, 调查, 查问 =enquiry(英)
silent	adj. 安静的,不吵闹的,沉默的,无言的 n. (复数)默剧
crude	adj. 粗鲁的,简陋的,天然的,未加工的 n. 原油
inclusive	adj. 包含...在内的, 包罗广泛的, 包括端点的 [计算机] 包括的
reside	v. 住,居留,属于
situate	vt. 位于, 坐落在 adj. 位于...的，坐落在...的
evidence	n. 根据, 证据 vt. vi. 证实, 证明
state	n. 州, 国, 情形 adj. 国家的, 州的, 正式的 vt. 说, 陈述, 声明, 规定
weighty	adj. 重要的, 沉重的，有力的
instinct	n. 本能, 天性, 直觉
cynic	n. 愤世嫉俗者，犬儒主义者，好挖苦的人
maximum	n. 极点, 最大量, 极大 adj. 最高的, 最大极限的
reprimand	v.&amp;n. 训诫,谴责 vt. 责难 n.申诉
intensity	n. 激烈,强度,强烈,剧烈
customer	n. 顾客，家伙
tense	adj. 紧张的, 拉紧的 vt. 使紧张, 拉紧 vi. 变得紧张 n. (动词的)时态
reputable	adj. 受好评的, 有声望的, 规范的
scandal	n. 丑闻,中伤,反感,耻辱
architecture	n. 建筑学, 建筑业, 建筑物, 结构  [总称]建筑物, 建筑风格
variable	adj. 可变的,易变的 n. 变量, 易变的东西
respondent	n.回答者； [法]（特指离婚诉讼的）被告； [生]反应，反射 adj.应答的； 有反应的； [法]被告的
expansion	n. 扩大,膨胀,扩充
urban	adj. 城市的
interface	n. 界面,接触面 vt. 连接,作接口 vi. 连接
experiment	n. 实验,试验,尝试 vi. 做实验,尝试
voyage	n. 航行,旅程 vt.& vi. 航行,旅行
theory	n. 理论,原则,看法,推测
involve	vt. 包含, 使陷入, 使忙于, 使卷入, 牵涉
odor	n. 气味,名声,气息
iron	adj. 刚强的 n. 铁, 熨斗, 坚强, (复数)铁制物 vt. 熨烫(平), 用铁装备 vi. 熨烫(平)
candidate	n. 候选人, 求职者
reluctant	adj. 不情愿的,勉强的
guarantee	n. 保证(书), 担保(书) n. 担保人; 抵押品 vt. 保证, 担保
extensive	adj. 广泛的,广阔的
broadcaster	n. 播音员
guide	vt.引路； 指导； 操纵； 影响 n.指导者； 向导； 导游； 有指导意义的事物
accessible	adj. 可得到的, 易接近的, 可进入的
strategic	adj. 战略的,重要的,基本的
scenic	adj. 风景好的, 戏剧性的
designate	adj. 指定的 vt. 指定,选派,标明
allusion	n. 提及,暗示
assignment	n. 分配,功课,任务,被指定的(课外)作业;(分派的)任务, 委派
thorough	adj. 彻底的, 完全的, 精心的
radius	n. 半径,桡骨,半径范围,辐射区
associate	vt.（使）发生联系； （使）联合； 结交； 联想 vi.联盟； 陪伴同事 n.合伙人； 伴侣，同志； 非正式会员 adj.联合的； 合伙的； 非正式的； （性质上）有密切联系的
threat	n. 威胁, 凶兆
definitely	adj. 明确地, 确切地 adv. 肯定地
disclose	vt. 揭露
mathematician	n. 数学家
resist	v. 抵抗, 耐得住, 压制 n. 保护膜
mixture	n. 混合, 混合物
behaviour	n. 行为(工作情况, 运转状态, 特点)
disregard	n. 不理会, 漠视 vt. 忽视, 不顾
cave	n. 山洞 v. (使)凹陷 vi. (in)塌落,倒坍
permission	n. 同意,许可,允许
hatch	n. 孵化,舱口 vt. 孵,孵出 vi. 孵化，破壳
fate	n. 命运,天意 vt. 注定
moral	adj. 道德(上)的,有道德的 n. 品行,寓意,道德
efficiency	n. 效率；效能；功效
retain	vt. 保持, 保留; 记住
anecdote	n. 轶事,奇闻
drastic	adj. 激烈的,猛烈的,极其严重的
anthropology	n. 人类学
prerequisite	n. 先决条件 adj. 作为前提的, 必备的
diagram	n. 图解,图表 vt. 用图解法表示
mould	n. 模子(样板,形状,霉菌,土,类型) vt. 模压(铸造,发霉,形成,轮廓相符合) vi. 发霉
consume	vt.  消耗，毁灭，吃，喝, 挥霍 vi. 耗尽生命, 被烧毁
specialist	n. 专家
surround	n. 环绕物 vt. 包围,环绕
attribute	n. 属性, 特征; 标志, 象征 vt. 归于, 属于
fertile	adj. 肥沃的,能繁殖的 n. 多产,肥沃
differ	vi. 不一致,不同(意见)
invasion	n. 侵入, 侵略
rigid	adj. 僵硬的,刻板的,严格的
sparse	adj. 稀少的, 稀疏的
approximate	adj. 大约的,近似的 vt. &vi. 接近,约等于
dwindle	v. 减少, 缩小
endurance	n. 忍耐, 忍耐力, 耐性
traditional	adj. 传统的
narrow	adj. 狭窄的，有限的；勉强的；精密的；度量小的 n. 海峡；狭窄部分，隘路 vt. 使变狭窄 vi. 变窄
fine	n. 罚款,罚金,结尾 vt. 罚款 vi. 净化，细化 adj. 美好的, 优质的, 精致的，晴朗的, 健康的，纤细的，恭维的，辞藻华丽的 adv. 恰好地，合适地
capitalism	n. 资本主义
circuit	n. 电路,一圈,巡回 vt. &vi. 巡回
surplus	adj. 多余的,过剩的 n. 过剩,剩余物,盈余,顺差
basin	n. 脸盆, 盆地, 流域, 水池
staff	n.参谋； 全体职员； 管理人员； 权杖 adj.行政工作的； 参谋的； 职员的； 作为正式工作人员的 v.在…工作； 为…配备职员； 任职于
franchise	n. 特权,公民权,特许经销权 vt. 赋予特权, 赋予公民权
furnishing	n. 供给(装备)
dealing	n. 经营方法，行为态度 (复数）dealings:商务往来，交往 动词deal的现在分词
historical	adj. 与历史有关的
averse	adj. 厌恶的, 反对的
moody	adj. 易怒的，喜怒无常的,情绪化的 Moody n. 穆迪(人名)
verification	n. 确认, 查证, 作证
awe	n. 敬畏 vt. 使崇敬
survivor	n. 幸存者
flat	adj. 平坦的, 单调的, 扁平的 adv. 平直地, 干脆地 n. [英]公寓 vt. 变平 vi. 降调
ascend	v. 上升, 攀登
tribe	n. 部落,种族,一伙人
banal	adj. 陈腐的, 平庸的
legitimacy	n. 合法, 适法, 正当
existing	adj. 现存的,现有的 [计算机] 现有的
position	n. 位置, 职位; 状态, 立场 vt. 安置, 决定...的位置
drawback	n. 不利点,退税
horizon	n. 地平线；视野；眼界
behavioural	adj. 行为的
attraction	n. 吸引, 吸引力, 有吸引力的人或事物
clue	n. 线索 vt. 提示
threshold	n. 极限,门槛,入口,开端
secretarial	adj. 秘书的
nurture	n. 养育, 照顾, 教育, 滋养, 营养品 vt. 养育, 给与营养物, 教养, 扶持
analyst	n. 分析家
noble	adj. 高尚的, 宏伟的, 贵族的, 高贵的 n. 贵族
mystical	adj. 神秘的 adj. 神秘主义的 adj. 有心灵象征意义的
imply	vt. 暗示,意味
commit	v. 委托(托付), 犯罪, 作...事, 承诺 [计算机] 委托
advertise	vi. 登广告 vt. 为...做广告, 宣传
predict	v. 预知, 预言, 预报
atlas	n. 地图集 Atlas: 擎天神，背负重物的人
transplant	vt. 移居, 移栽(植物), 移植(器官) vi. 能经得住移植 n. 移植, 被移植的事物
fictitious	adj. 假想的,编造的,虚伪的
presently	adv. adv. 不久, 一会儿, 现在, 目前
trigger	vt. 引发，引起；触发 vi. 松开扳柄 n. 扳机；[电子] 触发器；制滑机
tropic	n. 回归线,热带 adj. 热带的,向性的
uncertain	adj. 不确定的
prevent	v. 预防, 防止
endeavor	n. 努力, 尽力, 进取心 vt. 努力,尽力 vi. 企图, 谋求
dredger	n. 挖泥船
number	n. 号码,数字 v. 编号,加号码,总计 vi. 总计 vt. 编号
insulting	adj. 侮辱的 动词insult的现在分词形式
zeal	n. 热情, 热忱
localise	vt. 定位(局限)
private	adj. 私人的，隐蔽的 n. 士兵，列兵
pathetic	adj. 可怜的，悲哀的；感伤的；乏味的
mandatory	adj. 命令的, 强制性的, 受委托的 n. 受托管理者
traumatic	n. 外伤药 adj. 外伤的, 创伤的
seal	n. 印章, 封条, 海豹 v. 盖印, 封闭, 猎海豹
procession	n.队伍，行列； 一列，一排； 列队行进
sophisticate	n. 久经世故的人 vt. 玩弄诡辩,掺合,弄复杂
generational	adj. 世代的
occasional	adj. 偶然的, 不时的
congruent	adj.合适的，一致的，全等的
secretary	n. 秘书,部长,大臣,书记
successive	adj. 接连的, 连续的, 接二连三的
complicated	adj. 复杂的, 难懂的
productivity	n. 生产率, 生产能力
comprehension	n. 理解(力),领悟
persevere	v. 坚持, 孜孜不倦, 不屈不挠
suggest	vt. 建议,暗示,要求
prospect	n. 景色, 希望, 展望 v. 探勘, 寻找
arousal	n. 激励, 鼓励, 唤醒, 激发
contaminant	n. 杂质(污染物质,沾染物)
urge	n. 冲动 vt. 驱策,鼓励,力陈,催促 vi. 极力主张
tuition	n. 教诲,教学,学费
superior	n. 上级,高手,上标 adj. 上层的,上好的,出众的,高傲的
awkward	adj. 笨拙的 adj. 尴尬的
senior	n. 年长者,上司,毕业班学生 adj. 年长的,高级的,资深的
vague	adj. 模糊的,不明确的,说话含糊不清的,茫然的
separate	n. 分开, 抽印本 adj. 分开的, 各自的, 单独的 v. 分开, 隔开, 分居
pose	n. 姿势,姿态,装模作样 vt. 提出(问题),引起,定格 vi. 摆姿势,装模作样
pulse	n. 脉冲,脉波,脉搏 vt. &vi. 跳动,脉跳
survive	vt. 比…活得长,幸免于难,艰难度过 vi. 活着, 继续存在
accommodate	vi. 使自己适应 vt. 使一致，和解；提供方便；容纳；顾及
conservative	adj. 保守的,守旧的 n. 保守派(党),保守的人
haughty	adj. 傲慢的
cautious	adj. 十分小心的, 谨慎的
construction	n. 建设，建造，结构，构造
prevention	n. 阻止, 妨碍, 预防
contain	vt. 包含,容纳,克制,抑制 vi. 自制
container	n. 容器, 集装箱
emerge	vi. 浮现, (由某种状态)脱出, (事实)显现出来
adapt	vt. 使适应,改编 vi. 适应，适合
emotion	n. 情感,情绪,感动
hemisphere	n. 半球
severe	adj. 剧烈的, 严重的, 严峻的, 严厉的, 严格的
qualify	vt. 取得资格,有资格,限定,描述 vi. 取得资格, 有资格
consciousness	n. 意识,知觉,自觉,觉悟
simplistic	adj. 过分简单化的
propaganda	n. 宣传, 宣传的内容
adopt	v. 采用, 收养, 接受
virtually	adv. 几乎,实际上
operate	vi. 操作, 运转 vt. 起作用, 动手术
condone	vt. 宽恕；赦免
stabilise	v. (使) 稳定 =stabilize(美)
opinion	n. 看法,意见 v. 判断,意见,主张
momentum	n. 动力,要素, 势头,（物理）动量
disconnection	n. 断开
consequential	adj. 作为结果的(引出重要结果的, 自高自大的)
taint	n. 污点, 耻辱, 感染 v. 污染, 中毒
qualification	n. 资格, 条件, 限制
qualm	n. 疑惧, 紧张不安
aboriginal	adj. 原始的, 土著的
ordinary	adj. 普通的
council	n. 理事会,委员会, 商议
orderly	adj. 有秩序的, 整齐的, 一丝不苟的, 和平的 adv. 有秩序地，有条理地，依次地 n. 勤务兵, （医院的）勤务工
guideline	n. 指引，指导方针
industrialize	v. (使)工业化 =industrialise(英)
entrepreneur	n. 企业家
competitor	n. 竞争者,对手
plausible	adj. 似真实的,似合理的,说得蛮像回事的
implement	n. 工具, 器具; 当工具的物品 vt. 实施, 执行; 向...提供工具(或手段)
recipient	n. 接受者, 收信人
reclaim	v. 开垦, 纠正, 收回
enzyme	n. 酶
credit	n. 信用, 荣誉, 贷款, 学分 v. 归功于, 赞颂, 信任
photoperiodism	n. 光周期现象(光周期性)
estimate	n. 估计, 估价 v. 估计, 估价, 评价
doubtful	adj. 可疑的, 疑心的, 不确定的
confront	vt. 面临, 对抗, 遭遇
representation	n. 表示法,表现,陈述，答辩
resent	v. 愤恨,憎恶,怨恨
narrative	n. 叙述,故事 adj. 叙述的,叙事的,故事体的
cursory	adj. 匆匆忙忙的, 草率的, 粗略的
contend	vi. 奋斗,斗争,辩论 vt. 坚持认为,竞争
simplify	v. 简化, 使单纯 vt. 简化
weigh	vt. 权衡；考虑；称…重量 vi. 重量为…；具有重要性；成为…的重荷；起锚 n. 权衡；称重量
corrupt	adj. 腐败的,堕落的 vt. 使...恶化,贿赂,使...腐烂 vi. 腐烂,堕落
insufficient	adj. 不足的
trait	n. 特征,特点,特性,品质
appeal	n. 恳求, 上诉, 吸引力 n. 诉诸裁决 v. 求助, 诉请, 呼吁; 有吸引力
technological	adj. 科技的，工艺的
inept	adj. 不适当的, 无能的, 笨拙的
reserve	n. 预备品, 贮存, 候补 n. 克制, 含蓄 vt. 保留, 预订, 延期
reform	n. 改革,改正,感化 vt. 改革,改正,使悔改 vi. 改良,悔改
immigration	n. 移居, 移民
measurable	adj. 可测量的
currency	n. 货币; 流通
register	v. 记录, 登记, 注册, 挂号 n. 暂存器, 记录, 登记簿 n. (语)语域; 通风调节设备
existence	n. 存在, 生存
regulate	v. 有系统的管理,规定,调节
artistic	adj. 艺术的
reinforce	vt. 加强，加固；强化；补充 vi. 求援；得到增援；给予更多的支持 n. 加强；加固物；加固材料
extend	v. 扩充, 延伸, 伸展, 扩展
provided	conj. 假如,若是 adj. 预备好的,由...供给的
item	n. 项目,条款， 一件商品（或物品） adv. 也
allocation	n. 配置, 分配, 安置
interior	adj. 内部的,内地的,国内的,在内的 n. 内部
assembly	n. 集合, 集会, 装配
adaptable	adj. 能适应的，适应性强的，可改编的
scrutiny	n. 详细审查；监视；细看；选票复查
devour	vt. 吞食,耗尽,吞没,贪婪的享用
latent	adj. 潜伏的,潜在的 n. 隐约的指印, 指纹
represent	vt. 表现, 表示, 描绘, 代表 vi. 提出异议
conflict	n.冲突； 战斗； 相互干扰； 矛盾 vi.抵触； 争斗； 战斗； 冲突
judgement	n. 判断
aesthetic	adj. 美学的,审美的,有美感的 n. (复数)审美观
dismal	adj. 阴沉的, 凄凉的, 暗的
solid	adj. 固体的,结实的,可靠的,实心的 n. 固体,实心
pragmatic	adj. 实际的, 实用主义的
just	adj. 公正的,公平的,恰当的 adv. 正好,恰好
familiar	adj. 熟悉的,熟知的,不拘礼节的 n. 熟人,熟悉某种事物的人
subtlety	n. 微妙, 明敏
perfume	n. 香水,香气 v. 洒香水于,薰香
literal	adj. 逐字的, 字面上的, 文字的 [计算机] 文字的
period	n. 学时, 课时; 一段时间, 时期, 周期; 句号
harvest	n. 收获(期),成果,收获物 vt.& vi. 收割,收获
legitimate	adj. 合法的, 正当的, 合理的, 世袭的 vt. 使合法, 授权, 宣布...为合法
judicious	adj. 头脑精明的,贤明的,判断正确的
abuse	n.滥用； 恶习； 侮辱； 恶言 vt.滥用； 虐待； 辱骂
chain	n. 链,连锁,束缚 vt. 用铁练锁住,束缚,囚禁
duty	n.税，义务, 职责 adj. 值班的, 作为一种义务的
feature	n. 特征, 容貌 vt. 以...为特色 vi. 起重要作用
revolution	n. 革命, 旋转, 转数
alliance	n. 结盟,联盟,联姻 Alliance [地理名词]
allocate	v. 分派, 分配, 分配额
distribution	n. 分发, 分配, 散布, 分布
lure	n. 饵,诱惑 vt. 引诱,诱惑
antiquity	n. 高龄, 古老, 古物, 古迹
attitude	n. 态度, 看法, 姿势
multiple	adj. 许多,多种多样的 n. 倍数,并联
mechanism	n. 机制,原理，机械,机构,结构
chronological	adj. 按时间顺序的
endanger	vt. 危及，危害
data	n. (datum的复数)资料,数据
physiology	n. 生理学
direction	n. 方向,指导,用法说明,趋势
mystery	n. 神秘,秘密,神秘的人或事物
neighbourhood	n. 邻近，邻里关系
tragedy	n. 悲剧, 惨事, 灾难
uniformity	n. 同样,一致(性)
firefly	n. 萤火虫
equilibrium	n. 平衡,均衡
superiority	n. 优越性, 优势
barrier	n. 界线,屏障,障碍物 v. 以屏障隔开
hesitate	vi. 犹豫, 停顿，口吃，迟疑，踌躇 vt. 用犹疑的态度表示
scapegoat	n. 替罪的羔羊, 替人顶罪者 v. 使…成为替罪羊
aggression	n. 进攻, 侵犯, 侵害, 侵略
scenario	n. 情节梗概, 剧本
deficiency	n. 缺乏,不足,缺点
rough	adj.粗糙的，崎岖不平的； 粗鲁的； 狂暴的，汹涌的； 未经加工的 vt.粗暴地对待； 使粗糙； 草拟 n.粗糙的部分； 艰难，苦难； （高尔夫球场的）深草区 adv.粗暴地 vi.举止粗野
necessity	n. 需要, 必需品, 必然
various	adj. 各种各样的
commemorate	v. 纪念,庆祝 vt.&amp;n. 纪念
experimentation	n. 实验, 试验
supervisor	n. 监督人, 管理人, 检查员, 督学, 主管人,导师
trend	n. 趋势,倾向,方位 vi. 倾向,转向
architect	n. 建筑师
pollute	v. 弄脏,污染 vt. 污染
layer	n.层，层次； 膜； [植]压条； 放置者，计划者 vt.把…分层堆放； 借助压条法； 生根繁殖； 将（头发）剪成不同层次 vi.形成或分成层次； [植]通过压条法而生根
wage	n. 薪水,报偿,代价 vt. &vi. 开始,进行（战争、运动）
fantastic	adj. 极好的,难以相信的,奇异的,幻想的
artifact	n. 人工制品(制造物,石器)
theme	n. 题目, 主题
raw	adj. 生的,未加工的,原始的,不熟练的,寒冷的 n. 触到某人的痛处
coherence	n. 粘附(附着, 结合, 凝聚, 相参性, 同调, 连贯性)
campaigner	n. 从军者, 出征者，社会运动人士
tangible	adj. 有形的, 可触摸的, 确凿的, 实际的
absurd	adj. 荒唐的 n. 荒唐
exploitation	n. 开发,开采,自私的利用
inappropriate	adj. 不适当的,不相称的
orientation	n. 信仰,趋向,定位,适应,情况介绍 [计算机] 定向
attribution	n. 归因，归属，属性，特质
entitlement	n. 权利
originality	n. 独创性，创造力，新颖
shun	v. 避开, 规避, 避免
formula	n.   公式,配方,规则；代乳品 adj. （赛车的）级的，方程式的
illustration	n. 插图,例证,说明,图解
contrive	vt. 1. (不顾困难地)促成某事2. 巧妙地策划；精巧地制造（如机器） vi. 1. (不顾困难而) 设法做到(正式)
investigator	n. 调查者, 研究者, 审查者
scheme	n. 方案, 计划, 阴谋 v. 计画, 设计, 体系, 结构, 图谋
impact	n. 冲击(力), 冲突, 影响(力) vt. 挤入, 压紧; 撞击; 对...发生影响
factual	adj. 事实的, 真实的
speculate	vt. 推测,好奇 vi. 深思,投机
proceed	vi. 继续进行; 开始, 着手
weave	n. 编法, 织法, 编织 v. 编织, 组合, 编排
urgency	n. 紧急(的事)
speciality	n. 专长, 擅长
literary	adj. 文学的
complaint	n. 抱怨
journalism	n. 新闻工作, 新闻业, 新闻写作
complex	adj. 复杂的 n. 复合体
peripheral	adj. 不重要的,外围的 n. 外围设备
infirmity	n. 虚弱, 病身, 疾病，弱点
artificial	adj. 人造的,虚伪的,武断的
synthetic	adj. 综合的,合成的,人造的 n. 人工制品
property	n. 财产; 性质; 道具
pest	n. 害虫
function	n. 功能, 函数, 重大聚会 vi. 运行, 起作用
friction	n. 摩擦,摩擦力,分歧
attempt	vt.试图； 尝试 n.进攻； 尝试，冲击
urgent	adj. 急迫的,紧要的,紧急的
literate	n. 学者 adj. 精通文学的, 受过教育的
psychological	adj. 心理(学)的
public	adj. 公开的,众所周知的,公众的 n. 公共场合,公众,同好者
confusion	n. 混乱,混淆,不确定状态
vacuum	n. 真空,空间,真空吸尘器 adj. 真空的,产生(利用)真空的 vt. &vi. 用吸尘器打扫
fit	adj. 适宜的,对的,准备好的 v. 适合,安装 n. 适宜,发作,一阵
annual	adj. 每年的,年度的,一年生的 n. 年刊,年鉴,一年生植物
elect	n. 当选人, 被选的人, 上帝的选民 adj. 被选的, 选出的 v. 选举, 选择
vehicle	n. 传播媒介, 工具, 手段, 交通工具, 车辆;
secure	adj.安全的； 牢固的； 有把握的； 安心的 vt.保护； （使）获得； 使安全； 担保 vi.获得安全，变得安全； 安全，保险； 承保，担保； [航海学]停止工作
bilingual	adj. 双语的,用两种语言表达或书写的
anthropologist	n. 人类学家
empathy	n. n. 移情作用,共鸣, 执着投入，同理心
herb	n. 药草, 香草
progression	n. 前进
conversely	adv. 相反地
violence	n. 暴力,狂热
magnetic	adj. 有磁性的,有吸引力的,催眠术的
monotonous	adj. 单调的
prospective	adj. 未来的, 预期的
confiscate	v. 没收, 充公, 查抄
congenial	adj. 同性质的, 适意的, 趣味相同的，友善的
psychology	n. 心理学
supersede	vt. 取代,接替,使放在一边
dilute	vt. 冲淡,稀释 adj. 冲淡的,稀释的,微弱的
constrain	vt.强迫； 强使； 限制； 约束
generalisation	n. 归纳，推论 =generalization(美)
enquiry	n. [计] 询问，[贸易] 询盘
organic	adj. 器官的,有机的,根本的,接近自然的 n. 有机物质
organism	n. 生物体, 有机体
pub	n. 酒吧, 酒馆
consonant	n. 辅音 adj. 一致的,调和的,辅音的
motivation	n. 动机
entitle	v. 取名为,给与名称,叫做,使有权利
entrance	n. 入口 v. 使出神,使入迷 vt. 使出神
ideology	n. 观念学, 空论, 意识形态
minute	adj. 微小的,不重要的,详细的 n. 分钟,一会儿,会议记录 vt. 记录
abstain	v. 自制, 戒绝
narrate	v. 叙述 vt. 叙述(故事),描述
bulk	n. 大部分, 大多数, 大块, 大批, 容积, 体积 vi. 变大, 增加 vt. 膨胀, 出现 adj. 大量的
industrial	adj. 工业的,产业的 n. 工业公司
compensation	n. 补偿, 赔偿; 赔偿金, 物
realistic	adj. 现实的, 现实主义的
alter	v. 改变
error	n. 错误, 过失
migrate	v. 移动,移往,随季节而移居 [计算机] 迁移
establishment	n. 确立,制定,设施,机构,权威
engross	v. 使全神贯注，独占，大量收购，正式誊写，用大字体书写 n.
wealthy	adj. 富有的 n. 富人
manufacturer	n. 制造商
analysis	n. 分析, 解析
ancestor	n. 祖宗,祖先,原种
reminisce	v. 追忆,说...的回忆
utterance	n. 说话, 发表, 说话的方式
concentration	n. 集中, 专心, 浓度
mark	n. 污迹, 标记, 分数, 烙印, 纪录 vt. 做标记于, 留意, 打分数, 留下污痕, 使...明显 vi. 做标志, 记分, 留下印记
cryptic	adj. 秘密的(使用密码的, 意义深远的)
reasonable	adj. 合理的,有道理的,适度,通情达理的 adv. 合理地
curt	adj. 简略的, 简短的, 生硬的
incorporate	vt.组成公司； 包含； 使混合； 使具体化 vi.包含； 吸收； 合并； 混合
respectable	n. 品格高尚的人 adj. 值得尊重的, 人格高尚的, 不少的
subsidise	v. 消退, 下沉, 平息 vt. 给……补助, 资助
strive	v. 努力,奋斗,力争
recommend	vt. 建议, 推荐, 劝告 vt. 使成为可取, 使受欢迎
cure	n. 治疗,治愈,治疗法 vt. &vi. 治疗,治愈,改正
insurance	n. 保险
temporary	adj. 暂时的,临时的 n. 临时工
tactic	n. 战略,策略 adj. 战术的,有策略的
decipher	vt. 译解
therapist	n. 临床医学家
refuge	n. 避难(处), 庇护(所) v. 庇护, 避难(所)
furnace	n. 炉子,熔炉,闷热地带,严峻考验
instructor	n. 教师,讲师,指导书
rigor	n. 严格，严酷, 严密，严厉，[医]寒战，僵直，强直
regret	n. 遗憾, 后悔, 抱歉 v. 为...感到遗憾, 后悔, 惋惜
integrate	v. 整合, 使...成整体
parasite	n. 寄生虫,寄生生物，食客
intervene	vi. 插入,介入,干涉,调停 [计算机] 介入
miserable	adj. 悲惨的,痛苦的,贫乏的
default	n. 假设值,默认(值),不履行责任,缺席 v. 默认,不履行义务,缺席,拖欠 [计算机] 缺省
particle	n. 微粒,质点,极小量
explore	vt. &vi. 探险,探测,探究
explosive	adj. 爆炸(性)的 n. 炸药
irritate	vt.& vi. 激怒,使...发怒, 使疼痛或发炎
cancer	n. 癌,巨蟹座
insistent	adj. 坚持的, 迫切的
wisdom	n. 智慧,学问
intimidate	vt. 威胁,恐吓,胁迫
decay	n. 衰退, 腐败 v. 衰退, 腐败
absolve	vt. 宣告...无罪, 赦免
capacity	n. 能力, 容量, 容积; 资格, 职位 adj. (达到最大容量)满的
liberate	v. 解放, 使获得自由, 释出, 放出 vt. 解放, 使获自由
disconnect	vt. 使分离 vi. 断开，拆开
request	n. 要求, 请求 vt. 请求, 要求
sociable	adj. 好交际的, 社交的
dispense	vt. 分配，分发；免除；执行 vi. 免除，豁免
defect	n. 缺点 vi. 背叛
fairly	adj. 公平地, 相当 adv. 相当地
secular	n. 牧师,凡人 adj. 世俗的,现世的,不朽的
peak	n. 山顶,顶点,帽舌 vi. 到达高点,消瘦 vt. 使到达顶峰,竖起 adj. 处于顶峰状态的
sediment	n. 沉淀物
reputation	n. 声誉,好名声
peculiar	adj. 奇怪的,古怪的,特殊的,独特的 n. 特权
facade	n. 建筑物的正面,外表(犹指虚伪的)
proposal	n. 求婚, 提议, 建议
slaughter	n. 残杀, 屠杀, 大量杀戮 v. 残杀, 屠杀
amplitude	n. 广阔, 充足, 增幅 n. 振幅、波幅(物理)
dispel	v. 驱散, 驱逐
ironically	adv. 说反话地, 讽刺地
perceive	v. 察觉, 感觉, 认知, 理解
alienate	v. 使...疏远,离间,让与
diversify	v. 使成形形色色, 使多样化, 使变化
modify	vt. 修改,调正,缓和 vi. 修改
subsequence	n. 随后, 随后发生的事, 结果
equate	v. 同等看待, 使相等 vt. 等同, 使相等
sophisticated	adj. 复杂的；精致的；久经世故的；富有经验的 v. 使变得世故；使迷惑；篡改（sophisticate的过去分词形式）
desirable	adj. 值得有的,令人满意的,有吸引力的 n. 有吸引力的人
solidify	vt. 使牢固，使团结 vi. 变坚固，变结实
restore	vt. 恢复,归还,翻新
abrupt	adj. 突然的；唐突的, 陡峭的
migratory	adj. 迁移的, 流浪的
credibility	n. 可信用, 确实性, 可靠
detect	vt. 发现,探测信息,侦查 vi. 当侦探
spectrum	n. 光谱, （比喻）范围, 系列
ambivalent	adj. (对同一人或物)有矛盾看法的,或矛盾感情的, 矛盾心理的，矛盾情绪的
invader	n. 侵略者
embark	vt. &vi. 乘船,着手,从事
supplementary	adj. 补充的, 附加的
atmosphere	n. 大气, 气氛，空气, 格调, 情趣, 气压
expressive	adj. 表达的, 用作表达的, 富于表情的
affective	adj. 情感的
dense	adj. 不易看透的, 密集的, 浓厚的, 愚钝的
heal	vt. 痊愈,恢复,和解 vi. 痊愈
sustainable	adj. 可以忍受的；足可支撑的；养得起的；可持续的
lingual	adj. 舌的, 舌音的, 语言的 n. 舌音, 舌音字
psychologist	n. 心理学家
speech	n. 演讲,对话,话语,语言
noticeable	adj. 显而易见的
auto	n. autos=automobile 自动汽车 pref. 自动的,自己的
tourist	adj. 旅游的 n. 旅游者,观光者
track	n. 小路, 跑道, 轨道, 踪迹; 惯例, 常规 v. 跟踪, 追踪
tech	n. 技术人员，技术科技 abbr.(=technical, technically, technological)
director	n. 董事,经理,主管,指导者,导演
military	adj.军事的；军用的；讨厌的；好战的 n.军人；军队；武装力量
enroll	vt. &vi. 登记,使加入,卷起
facilitator	n. 帮助者，推进者
competitive	adj. 竞争的, 比赛的
presence	n. 出席,在场者,举止
transformation	n. 转型,转化,改造
epitome	n. 摘要, 缩影, 化身
survival	n. 生存,幸存者
laser	n. 激光
civil	adj. 国内的,公民的,文明的, 有礼貌的, 民用的
literacy	n. 读写能力，识字
claim	n. 要求,要求权;主张,断言,声称;要求物 vt. 要求,请求；主张,声称,断言
sponsorship	n. 发起(主办, 倡议, 赞助)
execution	n. 实行,完成,执行
classical	adj. 古典的, 典雅的, 经典的
treatment	n. 治疗,疗法,处理
emphasise	vt. 强调,着重
flexible	adj. 灵活的,易弯曲的,柔韧的,可变通的
electrical	adj. 电的,电气科学的
astronomy	n. 天文学
fascinate	vt. 使...入迷,吸引住 vi. 有吸引力
notable	adj. 显著的, 著名的 n. 名人
premature	adj. 早熟的,过早的,不按时的 n. 早产儿,早发
spreadsheet	电子表格, 数据表
obligation	n. 义务, 责任
inhabit	v. 居住于, 占据, 栖息
legal	adj. 法律的,合法的,法定的
terminate	adj. 有结尾的,有限的 vt. 结束,终止,满期 vi. 达到终点
obnoxious	adj. 可憎的, 不愉快的, 讨厌的
comet	n. 彗星
journal	n. 日记, 杂志, 日报
advise	vt. 劝告,警告,通知 vi. 劝告,与...商量
commentary	n. 实况报道，现场解说,评论,注释，批评
initial	n. (词)首字母 adj. 开始的, 最初的, 字首的 vt. 签姓名的首字母于
liable	adj. 有义务的,应负责的,有...倾向
strategy	n. 战略, 策略
note	n. 笔记, 注解, 备忘录, 音符, 音调, 票据, 便条, 纸币 vt. 记录, 注解, 注意
formulation	n. 形成, 简洁陈述, 公式化
previous	adj. 在...之前, 先, 前, 以前的
fortunate	adj. 幸运的,侥幸的
immediate	adj. 立即的, 即刻的, 直接的, 最接近的
revert	vi. 恢复,复归,回到
affecting	adj. 感人的, 动人的 动词affect的现在分词
committee	n. 委员会
linen	n. 亚麻布,亚麻线,亚麻制品 adj. 亚麻布制的,亚麻的
impression	n. 印象, 效果
absenteeism	n. 旷课, 旷工
subject	n. 科目, 主题; 缘由 n. (君主国)国民; 实验对象 adj. 服从的, 易患的 vt. 使隶属, 使服从; 使遭遇
oblige	vt. 强制, 施恩惠 vi. 帮忙
repertoire	n. (准备好演出的)节目, 保留剧目, (计算机的)指令表, 指令系统, &lt;美&gt;(某个人的)全部技 能, 清单,指令表
process	n.过程； 工序； 做事方法； 工艺流程 vt.加工； 处理； 审阅； 审核 vi.列队行进 adj.经过特殊加工（或处理）的
vulnerable	adj. 易受伤害的, 有弱点的
substantial	n. 重要部份, 本质 adj. 大量的, 实质上的, 有内容的
universe	n. 宇宙
approval	n. 批准, 认可, 同意, 赞同
adaptation	n. 改编,适应,改编成的作品
perceptual	adj. 感性的, 知觉的
frustration	n. 打破,挫折,顿挫 [计算机] 失败
frenzy	n. 狂暴, 狂怒
promote	vt. 促进, 提升, 升迁; 发起; 促销
frugal	adj. 节俭的
deprivation	n. 剥夺, 剥夺官职, 免职
gene	n. 基因
proportion	n. 比例,均衡,部分 vt. 使成比例,使均衡,分摊
sum	n. 总数(计),金额,顶点,概略,一笔钱 vt. 总计,概括 vi. 总计
propose	v. 计划, 打算, 向...提议; 求婚
conclusion	n. 结论
convergence	n. 汇聚,汇合点,收敛
conductor	n. 售票员，导体，指挥
conference	n. 会议
inhibit	vt. &vi. 禁止,抑制 [计算机] 禁止
economical	adj. 节俭的, 经济的, 合算的
publication	n. 出版, 发行, 出版物, 公布, 发表
texture	n. 质地；纹理；结构；本质，实质
architectural	adj. 建筑的,建筑学的,建筑术的
abstract	n. 摘要,抽象的东西 adj. 抽象的,理论的 vt. 移除,摘要,偷 vi. 做摘要
recruitment	n. 征募新兵, 补充
popularity	n. 普及,流行
militant	adj. 好战的, 积极从事或支持使用武力的
conscience	n. 良心, 责任心, 顾忌
sequence	n. 序列, 一系列, 顺序, 一组镜头 vt. 安排顺序
accidental	adj. 意外的,偶然的,附属的 n. 偶然,不重要的东西,变调的临时符号
hamper	n. 食盒,食篮 v. 阻碍,使...困累,困累
intermittent	adj. 间歇的,断断续续的
rationale	n. 基本原理(理论基础的说明,原理的阐述)
consist	n. 组成 vi. 组成,存在,一致
vegetable	n. 蔬菜；植物人；生活单调乏味的人 adj. 植物(性)的；得自植物的；关于植物的；蔬菜的
accuracy	n. 准确(性), 精确度
abundance	n. 丰富,充裕
avoidance	n. 避免
consumption	n. 消费
contemporary	n. 同时代的人；同时期的东西 adj. 当代的；同时代的；属于同一时期的
complementary	adj. 补充的, 互补的
misconception	n. 误解, 错误想法
concede	vt. 承认,给予 vi. 让步
partnership	n. 合伙, 合股
employee	n. 雇员
naturalistic	adj. 自然的,自然主义的,博物学的
uniform	adj. 一致的,统一的 n. 制服 vt. 穿制服
convey	vt. 传达,运输,转移 [计算机] 输送
gloat	v. 满足地看，沾沾自喜，幸灾乐祸
maintain	vt. 维持; 维修, 保养; 坚持; 断言
cope	v. (with)竞争,对抗,对付,妥善处理 vi. 对付,妥善处理
debate	n. 辩论,讨论 vt. 争论,思考 vi. 商讨,辩论
engine	n. 发动机, 引擎, 机车, 火车头 vt. 装引擎
minor	adj. 次要的, 较小的, 二流的, 未成年的 n. 未成年人, 辅修科目, [音乐]小调 vi. 辅修
contemplate	vt. 注视,沉思,打算
dramatic	adj. 戏剧性的,引人注目的,给人深刻印象的
oriental	adj. 东方(人)的,贵重的
visual	adj. 视觉的 n. 画面, 图象
equal	adj. 相等的,平等的,胜任的 n. 对手,匹敌,同辈 vt. 等于,比得上
speculation	n. 沉思, 推测, 投机
recede	vi. 后退,减弱 vt. 撤回
immaculate	adj. 洁白的(无缺点的,无瑕疵的)
impasse	n. 僵局, 死路
commentator	n. 注释者(注释者,解说员,新闻广播员)
comprehend	vt. 充分理解(综合,包含)
privacy	n. 隐私, 隐居, 秘密
prosper	v. 兴隆,成功,使...昌盛
sight	n. 景观, 视力, 眼界 vt. 看见, 观看 vi. 瞄准
sign	n. 符号, 正负号, 手势, 迹象, 招牌 v. 签, 做手势, 做标记
herbalism	n. 草药医术学
inadequate	adj. 不充分的,不适当的
relentless	adj.不懈的； 坚韧的，不屈不挠的； 不间断的； 未减轻的
analyse	vt. 分析, 检讨, 细察
rhetoric	n. 修辞, 华丽虚饰的语言, 修辞学
narrator	n. 叙述者(讲解员,播音员)
curtail	vt. 缩减, 削减，截短
solemn	adj. 庄严的, 严肃的, 隆重的
retail	n. 零售 vt. 零售 adj. 零售的 adv. 以零售形式
retort	v. 反驳, 回嘴, 反击 n. 反驳, 顶嘴 n. 蒸馏器
recollect	v. 回忆, 回想, 忆起
pretense	n. 借口, 虚假, 伪装
suffice	vi. 足够,合格 vt. 使...足够
counsel	n. 商议, 忠告, 法律顾问 v. 商议, 劝告
initially	adv. 最初, 开头
prefer	vt.更喜欢； 提升，提拔； 给予（债权人）优先权； 提出（控告） vi.更喜欢，宁愿
tentative	n. 试验,假设 adj. 试验性质的,暂时的,犹豫不决的
appointment	n. 约会, 预约, 任命, 委派, 官职, 设备
approach	n. 接近; 途径, 方法 v. 靠近, 接近, 动手处理
appropriate	adj. 适当的, 相称的 vt. 拨出(款项); 占用
executive	n.总经理； 行政部门； [计算机]执行指令 adj.执行的； 管理的； 政府部门的
calculation	n. 计算
interpret	v. 解释, 演出, 翻译 [计算机] 解释
grass	n. 草 vt. 以牧草喂养,覆盖着草
abstraction	n. 抽象, 抽象概念, 心不在焉
fibre	n. 纤维, 纤维组织, 织地
certain	adj. 一定的 pron. 某几个,某些  肯定的,无疑的,必然发生的
reliable	adj. 可靠的,可信的
expression	n. 表达,表示,表现,表情,措辞,词句
extension	n. 延长,扩充,范围,分机号码
suppress	vt. 镇压,使...止住,禁止
capable	adj. 有能力的，足以胜任的, 有...倾向的
savor	n. 滋味, 气味, 食欲, 特定的味道或气味, 一种有特色的性质 vi. 有...的滋味, 有...气味 vt. 加调味品于, 使有风味, 尝到或闻到, 尽情享受
delighted	adj. 高兴的, 快乐的 v. 快乐, 喜悦
supply	n. 补给,供给,供应，贮备 vt. 补给,供给,提供,提供足够以满足
registration	n. 登记,注册,挂号
deviate	vt. 使偏离, 脱离 vi. 违背,偏离 n. 叛离者,偏差, 不正常的人或物 adj. 离经叛道的
naive	adj. 天真的,幼稚的
minimum	adj. 最低的, 最小的 n. 最小量, 最低限度
consecutive	adj. 连续的,连贯的
integration	n. 综合, 集成, 同化
dioxide	n. 二氧化物
preconception	n. 预想(先入之见,偏见)
missile	n. 导弹,投射物
conspicuous	adj. 显著的,显而易见的, 显眼的
hormone	n. 荷尔蒙, 激素
perform	v. 执行, 表演, 做
moderate	adj. 适度的, 稳健的, 温和的, 中等的 v. 节制, 使...稳定, 使...缓和 n. 稳健的人
sociology	n. 社会学, 社会关系学, 群落生态学
predator	n. 食肉动物,掠夺者
response	n. 反应, 响应; 回答
skeptical	adj. 怀疑的
summarise	v. 概括 =summarize（英）
persuade	v. 说服 vt. 劝说,说服
favourite	adj. 特别喜爱的 n. 特别喜爱的人(或物)
photograph	n. 相片 vi. 照相,摄影 vt. 给...照相
adolescent	adj. 青春期的, 青少年的 n. 青少年
physical	adj. 身体的,物理的,物质的 n. 体检
motion	n.运动； 手势； 动机，意向； 请求 vt.打手势； 向某人点头或摇头示意； 打手势要求[指示] vi.运动； 打手势
revise	n. 校订, 修正, 再校稿 v. 校订, 修正, 校正
encyclopaedia	n. 百科全书
standardize	v. 标准化, 使合于标准
encounter	n. 意外的相见,遭遇 vt. &vi. 遇到,偶然碰到,遭遇
assistance	n. 帮助, 援助
authority	n. 权威；权力；当局
hypocrite	n. 伪君子, 伪善者
stubborn	adj. 顽固的, 倔强的，难对付的
chief	adj. 主要的, 首席的 n. 首领
engagement	n. 诺言, 约会, 婚约, 交战, 雇用, (机器零件等)啮合
spray	n. 水沫,喷雾器 vt. &vi. 喷雾,扫射,喷射
spread	n. 传布, 伸展 adj. 扩延的 v. 传布, 推广, 伸出
suicide	n.自杀； 自杀者； 自杀行为 vt.自杀 adj.自杀的
congested	adj. 拥挤的 动词congest的过去式和过去分词
erosion	n. 腐蚀,侵蚀
discourage	vt. 使气馁,阻碍
transform	vt. 转换,变形 vi. 改变 n. 变形
organisation	n. 组织，团体，有机体 =organization（英）
generous	adj. 慷慨的,宽宏大量的,丰盛的,味浓的
exile	n. 放逐,流放,被放逐者 vt. 放逐,流放
treat	v. 对待, 治疗，处理，请客，视为 n. 款待，宴飨
overt	adj. 公开的, 明显的, 公然的
archaeology	n. 考古学，古迹，文物
intensive	adj. 强烈的, 密集的, 精细的, 强调的 n. (语法)强调成份
publisher	n. 出版者, 发行人
motivated	adj. 有积极性的
term	n.学期； 条款； 术语； 期限 vt.把…称为； 把…叫做
triangle	n. 三角(形)
facilitate	vt. 帮助, 使...容易, 促进
positive	adj. 肯定的, 积极的, 绝对的 adj. 正面的, 正数的, 阳性的
possess	v. 持有,克制,为...着迷
avail	vi. 有利 vt. 有用 n. 益处
cue	n. 字母Q,信号,线索,球杆 vt. 暗示,用球杆打球 vi. 使用球杆
benevolent	adj. 仁慈的,乐善好施的
collaboration	n. 合作, 通敌
consumerism	n. 用户至上主义, 商品的消费和销售性服务
establish	v. 建立, 确立, 创办
sinister	adj. 不吉利的, 凶恶的, 左边的
communicator	n. 传播者, 传播工作者
deteriorate	vt. (使)恶化 vi. (使)恶化, 瓦解, 衰退
collective	adj. 集体的,共同的 n. 集体
tolerant	adj. 宽容的, 容忍的
column	n.纵队，列； 圆柱； 专栏
advertisement	n.&amp;adv. 广告
combine	n. 集团,联合收割机 v. 化合,结合,联合 vi. 结合,联合 vt. 使结合,使联合
prepare	vt.准备； 预备（饭菜）； 配备； 使（自己）有准备 vt.& vi.筹备，进行各项准备工作； 做好思想准备； 作出，制订； 锻炼（身体等），训
liberal	n. 自由主义者, 宽容大度的人, (Liberal)自由党人 adj. 无偏见的, 慷慨的, 不拘泥的, 宽大的, 开明的
prescribe	vi. 规定,开药方 vt. 规定,命令,开处方
liberation	n. 解放，解放运动（为获得平等权利和地位的行为）
preserve	vt.保护； 保持，保存； 腌制食物； 防腐处理 vi.保鲜； 保持原状； 做蜜饯； 禁猎 n.蜜饯； 防护用品； 禁猎地； 独占的事物（或范围）
indifference	n. 不重视, 无兴趣, 漠不关心
criticise	v. 批评，评论，吹毛吹疵 =criticize（美）
recruit	n. 招聘,新兵,新成员 vt.&vi. 恢复,补充,徵募
scan	vt. 扫描；浏览；细看；详细调查；标出格律 vi. 扫描；扫掠 n. 扫描；浏览；审视；细看
standardise	vt. 使标准化，使合标准 =standardize(美)
prime	adj. 最初的,首要的,最好的，典型的 n. 青春,壮年,全盛时期 vt. 事先指点,在（金属、木材等上）打底漆  vi. 变得首要
dredge	n. 挖泥机, 捞网 v. 用挖泥机疏浚 v. 把粉撒在
exaggerate	vt. &vi. 夸大,夸张
principle	n. 原则, 原理, 主义, 信念
partition	n. 分割,隔离物,隔墙 v. 区分,隔开,分割
frame	n. 框,结构,骨架 v. 构成，把...框起来，陷害 adj. 木结构的
object	n. 物, 物体, 目标, 宾语 v. 反对，提出...作为反对的理由
promising	adj. 有希望的,有前途的
dissertation	n. 论文
economist	n. 经济学家 &lt;古&gt;节俭的人
fortify	vt. 强化，增强，筑防御工事于，（物质或精神上）支持或鼓励 vi. 构建防御工事
appear	vi. 出现,显得,出版,抵达
appoint	vt. 任命,指定,预约,装饰 vi. 行使任命权
adaptive	adj. 适合的,适应的,能适应的
adventurous	adj. 爱冒险的,大胆的,危险的
compose	vt. 组成, 写作, 作曲, 使镇静 vi. 创作
coerce	vt. 强制，迫使，威胁
comprise	vt. 包含,构成
timid	adj. 胆怯的,害羞的
subtract	vt. 扣掉 vi. 减少
seize	vt. 抓住,攻占,理解,侵袭 vi. 抓住,卡住,终止
linguistic	adj. 语言的, 语言学的
competent	adj. 有能力的,胜任的,足够的
solitary	adj. 孤独的,独立的,荒凉的 n. 隐士,
genetic	adj. 基因的, 遗传的, 起源的
isolation	n. 隔离, 孤立
horrible	adj. 可怕的,令人毛骨悚然的,令人讨厌的
effect	n. 结果, 影响, 效果; 要旨 vt. 招致, 引起; 实现, 达到
similarly	adv. 相似地, 类似地
accelerate	vt. 加速,提前,跳级 vi. 加速
impair	vt. 损害,削弱 [计算机] 损伤
vanish	vi. 消失,不见了,绝迹 vt. 消失
generation	n. 代, 一代
variety	n. 多样, 种类, 杂耍
set	vt.放置，安置； 使处于某种状况； 设置； 摆放餐具 vi.落山； 出发； 凝结 n.一套，一副； 集合； 布景； 电视机 adj.固定的； 位于…的； 顽固的； 安排好的
purity	n. 纯净, 纯正, 纯粹
electricity	n. 电力；电流；强烈的紧张情绪
electronic	adj.电子的； 电子操纵的； 用电子设备生产的； 用电子设备完成的
aggregate	n. 合计, 总计, 集合体 adj. 合计的, 集合的, 聚合的 v. 聚集, 集合, 合计
classic	n. 古典作品,杰作,第一流艺术家 adj. 第一流的,最优秀的,古典的
elimination	n. 除去, 消除
pretentious	adj. 自负的, 自命不凡的，炫耀的
priority	n. 优先权, 优先顺序, 优先
probe	n. 探针,调查,探测器 vt. 用探针测,详细调查 vi. 详细调查
acute	adj.尖的，锐的； 敏锐的，敏感的； 严重的，剧烈的； [医]急性的, 激烈的, 尖锐的
lung	n. 肺,呼吸器官
adequate	adj. 足够的, 充足的, 适当的, 能胜任的
adjust	vt. 调整, 使...适于 vi. 适应
convention	n.会议； 全体与会者； 国际公约； 惯例，习俗，规矩
employment	n. 工作,职业,雇用,使用
convert	v. 使转变, 使...改变信仰, 倒置 n. 皈依者, 改宗者
operator	n. 操作员,管理者,技工,报务员
myth	n. 神话
affection	n. 慈爱,爱,感情
vital	adj. 至关重要的, 生死攸关的, 有活力的, 充满生机的
oppose	vt. 反对,以...对抗,抗争
opposite	adj. 相对的, 相反的, 对面的 n. 对立物，对立者，对手 adv. 在对面地，处于相反位置地 prep. 在...对面
oppress	v. 使(心情等)沉重,使烦恼,压迫,压制某人 vt. 压迫,压制
erratic	adj.飘忽不定的； 行为古怪，反复无常； （运动或行为）不规则的
versatile	adj. 多才多艺的,多方面的，通用的，
core	n.中心，核心，精髓； 果心，果核； [地质学]地核； [计] 磁心 vt.去（果）核，挖去…的果心； 提取岩芯（样品）
nonetheless	adv. 尽管如此(仍然) conj. 尽管如此(仍然)
coach	n. 大巴, 教练; (火车)客车车厢, 四轮马车, 经济舱 vt. 训练, 指导 vi. 训练, 指导
vote	v.投票，选举； 提议； 投票表决； 公认，由舆论决定 n.投票，表决； 投票数； 投票权； 决议
quantitative	adj. 数量的,定量的
pesticide	n. 杀虫剂
academy	n. 学院,学术,学会
humane	adj. 仁慈的，人道的
indication	n. 象征,迹象,指示,表示
specifically	adv. 特定地,明确地
illusion	n. 幻觉,错觉,错误的信仰(或观念)
equation	n. 相等,方程(式),等式,均衡
era	n. 纪元, 时代, 年代
phobia	n. 恐怖病, 恐怖症
influential	adj. 有权势的,有影响的 n. 有影响力的人物
reconstruct	vt. 重建, 修复, 重现
inhabitant	n. 居民
maximal	adj. 最大的, 最高的
injury	n. 受伤处,损害,伤害
criminal	adj. 犯罪的, 刑事的, 无耻的 n. 罪犯
conceptual	adj. 概念上的
subsidiary	adj. 辅助的,附属的 n. 子公司,附属机构
reality	n. 现实,实际,真实
disciplinary	adj. 训练的, 规律的, 训戒的
overlap	n. 重叠,重复 vt. 重叠,重复 vi. 有重叠部分 [计算机] 重叠
adverse	adj. 不利的；有害的；反面的
reservation	n. 预定，保留意见
consumer	n. 消费者,用户, 消费品
install	v. 安装,安置,使...就职 n.[计算机] 安装,DOS命令 : 装入结束且驻留软件
incoherent	adj. 不连贯的, 语无伦次的
voyager	n. 航行者, 航海者
evolution	n. 进化, 发展, 进展
revulsion	n. 剧变, 非常的厌恶, 剧烈的反应
recommendation	n. 推荐, 介绍
contour	n. 轮廓(等高线,周线,电路,概要) vt. 画轮廓(画等高线) adj. 显示轮廓的
predictable	adj. 可预言的
amoral	adj. 与道德无关的, 超道德的
apparent	adj. 显然的；表面上的；似乎真实的
predominate	v. 掌握,控制,成为主流
juvenile	adj. 年轻的,青少年的,幼稚的 n. 青少年,青少年读物,幼雏,扮演少年的演员
initiate	n. 创始人 adj. 新加入的 vt. 开始,创始,启蒙,介绍加入
custom	n. 习惯, 风俗, 海关
tension	n. 紧张,张力,拉力 vt. （使金属线、帆等）拉紧
intentional	adj. 企图的, 策划的, 故意的
abolish	vt. 废止,革除
tribal	adj. 部落的, 种族的
chronic	adj. 长期的,慢性的,惯常的
delusion	n. 错觉
invade	vt. 侵略,侵害,拥入
relation	n. 关系,家人,亲戚,叙述,陈述
express	n. 快车, 快递, 专使 adj. 急速的, 明确的, 直接的 adv. 用快递; 特意地 vt. 表达, 表示; 挤压出; 快递
discern	vt.看出； 理解，了解； 识别，辨别 vi.辨明，分清
passive	adj. 被动的,消极的 n. 被动性
guidance	n. 引导,指导,导航系统
detrimental	adj. 有害的 n. 有害的人或事
probability	n. 可能性, 或然率, 机率
revitalize	v. 使复活, 使重新充满活力 vt. 使复兴, 使苏醒, 使复活, 使恢复
deter	v. 制止,使...断念
query	n. 疑问,疑问号,质问 vt. 询问,表示怀疑
cognize	v. 认知，认识
signify	v. 象徵, 预示
textile	adj. 纺织的 n. 纺织品
society	n. 社会, 社团，阶层圈子
grief	n. 悲痛,忧伤
diminish	vt. 减少,变小, 减损 vi. 变少, 逐渐变细
delight	n. 快乐,高兴 vi. 给与乐趣,使高兴 vt. 使高兴
legislation	n. 立法, 法律
subjective	adj. 主观的 n. 主格,主观事物
defeat	n. 败北,失败 vt. 击败
disproportionate	adj. 不成比例的
treatise	n. 论文, 论述
subside	vi. 沉没,平息
dusty	adj. 满是灰尘的
ecologist	n. 生态学家
cattle	n. 牛 n. 家畜，马，无价值的人，畜牲
desert	n. 沙漠,荒地,应得(的惩罚或奖励)adj. 沙漠的,荒凉的vt. 遗弃vi. 擅离职守
dogmatic	adj. 教条的, 武断的
interval	n. 间隔,休息时间, (数学)区间, (音乐)音程
diversion	n. 转向, 转移, 娱乐活动
perspective	n. 远景, 看法, 透视 adj. 透视的
fatigue	n.   疲乏,疲劳,累活 adj. 疲劳的 vt.  使...疲劳,使...心智衰弱 vi.  疲劳
destruction	n. 破坏,毁灭,破坏者
infrastructure	n. 下部构造, 下部组织, 基础结构, 基础设施
determine	vt.& vi.（使）下决心，（使）做出决定 vt.决定，确定； 判定，判决； 使决定； 限定 vi.[主用于法律]了结，终止，结束
photographic	adj. 摄影的，逼真的
span	n.共轭（马、骡）； 跨度，墩距； 一段时间； [航] 跨绳 vt.缚住或扎牢； 跨越时间或空间； 以掌测量； 以手围绕测量类似测量
drawing	n. 图画,绘图技巧,素描
enforcement	n. 厉行, 执行, 强制
lucrative	adj. 有利益的,获利的,合算的
parallel	adj. 平行的,相同的,类似的,并联的 adv. 平行地 n. 平行线(面),相似物,对比 vt. 相比,相应,与...平行
glib	adj. 能说善道的
curative	adj. 治病的, 有治病效力的 n. 医药, 治疗药
eligible	adj. 可以选的,有资格的,合格的 n. 有资格者,合格者,适任者
distinct	adj. (from)独特的,不同的,明显的,清楚的
justified	adj. 有正当理由的,合理的,合法化的
exemplify	vt. 例证,例示
adhere	vi. 坚守于, 对...忠贞, 紧抓着, 遵守 vt. 使附着, 使粘牢
symbolize	v. 象征, 用记号表现
blunt	adj. 迟钝的,钝的,直接的 vt.& vi. 使变钝 n. 混了大麻的雪茄
mysterious	adj. 神秘的,不可思议的
squander	v. 浪费, 使...散开
prehistoric	adj. 史前的
imagine	vt. 想像,幻想,猜测 vi. 想像起来,认为
relationship	n. 关系, 关联
circulate	vi. 流通,循环,传播 vt. 使流通
disease	n. 疾病,弊端
indicator	n. 指示器, 指示剂 [计算机] 指示符
transmit	vt. 传输, 传送, 代代相传, 传达 vi. (以无线电或有线电的方式)发送信号
exclusive	adj. 独占的, 唯一的, 排外的; 高价的, 时髦的 [计算机] 互斥的 n. 独家新闻, 独权
discrete	adj. 不连续的 离散的 [计算机] 分离 离散
necessary	adj. 必需的,必要的,必然的 n. [pl.]必需品
archaeologist	n. 考古学家
constitution	n.建立，组成； 体格； 构成方式； 宪法
libel	n. (文字)诽谤, 侮辱 vt. 诽谤, 中伤, 损害名誉 vi. 发表诽谤言论
supplement	n. 补充物,增刊 vt. 补充,增补
extinct	adj. 灭绝的,熄灭的 n. 消灭,熄灭
divide	vt.& vi.分； 划分； 分离； （使）产生分歧 n.分水岭，分界线； 分配
triumph	n. 凯旋,欢欣 vi. 得胜,成功,庆功
viable	adj. 能生存的,可行的,能居住的的
assurance	n. 保证,确信,肯定,自信,(人寿)保险
disposable	adj. 用完即可丢弃的
complacent	adj. 满足的, 自满的, 得意的
oppression	n. 压抑, 沉闷, 压迫手段
narration	n. 叙述
novice	n. 新手,初学者
tunnel	n. 隧道,地下道 v. 挖隧道
obedience	n. 服从, 顺从
document	n. 文件,公文 vt. 记载,用文件等证明 [计算机] 文档
idealistic	adj. 理想主义的
publicise	vt. 宣传，宣扬 =publicize(美)
firework	n. 焰火 (复数)fireworks:烟火大会,(热情,怒气等的)迸发
collapse	n. 崩溃,倒塌,暴跌 vi. 倒塌,崩溃,瓦解,折叠 vt. 倒塌,缩减
fallible	adj. 易错的,可能犯错的
leisure	n. 闲暇；空闲；安逸 adj. 空闲的；有闲的；业余的
angle	n. 角(度),角落 vt. 斜移,转变角度 vi. 钓鱼,谋取,转变角度 n. (Angle)盎格鲁人
simulation	n. 模拟,仿真,赝品
praise	n. 赞美,称赞,崇拜 vt. 称赞,归荣誉于,赞美 vi. 赞美
selective	adj. 选择的, 选择性的
minimise	vt. 成极小(求最小值, 轻视, 信务剧减)
discriminate	vt. 区分，区别对待 vi. 辨别，差别对待
anticipation	n. 预期, 预料
flaw	n. 缺点,裂纹,瑕疵,突然的狂风天气 vi. 变得有缺陷 vt. 使破裂
mania	n. 狂躁, 热衷, 狂热
indicate	v.指明, 表明, 显示, 象征, 指示
agreement	n. 同意, 一致, 协议
trivial	adj. 琐碎的, 不重要的
investor	n. 投资者
ignorant	adj. 不知道的, 无知的, 愚昧的
former	adj. 以前的,在前的 pron.&amp;n. 前者
stress	n. 紧张, 压力 v. 强调, 着重 vt. 强调 n.负载
overwhelm	v. 淹没,受打击,压倒
algorithm	n. 算法
sufferer	n.受难者,患者,被害者
scent	n. 气味,香味,痕迹 vt. 闻出,发觉,使充满味道,得到...的暗示 vi. 嗅闻,循着遗臭追踪,散发气味
flippant	adj. 轻率的, 没礼貌的 adj. [古]能说会道的
implication	n. 暗示,含意
ancient	adj. 古代的,古老的 n. 古人, 古货币
welfare	n. 福利,社会保障,幸福 adj. 福利的
abandonment	n. 放弃, 自暴自弃, 放纵
subsequent	adj. 随后的,后来的
conceive	vt. &vi. 构思,以为,怀孕
congest	vt. 使充满, 使拥塞, 使充血 vi. 充塞, 充血
succeed	vt. 成功,继承,继续 vi. 接替,有作为
dull	adj. 呆滞的,迟钝的,无趣的,钝的,暗的 vt. 使变钝 vi. 变钝
literature	n. 文学, 文献
prominent	adj. 杰出的,显著的,突出的
collection	n. 收藏品,收集物,小组,集合
dilemma	n. 困境,进退两难
fruitful	adj. 多产的, 富有成效的
loan	n. 贷款, 借出, 债权人 v. 借, 供应货款, 借给
informative	adj. 情报的, 使知道消息的, 见闻广博的
fundamental	adj. 基本的,根本的,重要的 n. 基本原理,基础
furnish	vt. 布置,提供,装备
assemble	vt. 聚集,集合,装配 vi. 集合, 聚集
circulation	n. 流通,循环,发行量,消息传播
generative	adj. 生殖的, 生产的, 有生殖力的
absolute	adj. 绝对的,完全的,无限制的,独立的,专制的 n. 绝对的事物
portray	v. 描写,描写...的肖像,逼真地描写
projector	n. 放映机(探照灯, 发射装置, 设计者, 制图投射线)
whale	n. 鲸,大量 vi. 捕鲸 vt. 鞭打,打击,打败
capability	n. 能力,才能,性能,容量
survey	n. 调查; 纵览, 视察, 测量 vt. 审视, 视察, 通盘考虑, 调查; 勘测 vi. 测量, 勘测
dominance	n. 支配(控制, 统治, 权威, 优势)
punch	n. 打洞器,钻孔机,殴打 n. 酒、水、糖等制成的鸡尾酒 vt. 以拳重击,开洞,剪票,按(键)
minimal	adj. 最低限度的,最小的
election	n. 选举
category	n. 种类, 类别
presentation	n. 陈述, 介绍, 赠与 n. [美]讲课, 报告
constant	adj. 经常的, 不变的 n. 常数, 恒量
venture	n. 冒险,风险,投机 vt. 敢尝试,谨慎地做，冒险一试 vi. 冒险做
presume	vt. 姑且认定，假定，推测，认为是理所当然 vi. 假设，越权行事
corporate	adj.社团的, 法人的, 共同的, 全体的
misleading	adj. 使人误解的
sympathy	n. 同情,忠诚,感应
profound	adj. 极深的,深奥的,深厚的,严重的
vigorous	adj. 精力充沛的,元气旺盛的,有力的
photographer	n. 摄影师
convenient	adj. 方便的
historian	n. 历史学家，编史者
cube	n. 立方体,立方 vt. 求...的立方 adj. 立方的
reciprocate	v. 互换, 交换, 报答，往返运动
clinic	n. 诊所,门诊部,科室
deposit	vt. 存放, 堆积, 使沉淀 vi. 沉淀 n. 存款, 定金, 堆积物
fitness	n. 适合度（生物学术语） n. 健康
threaten	vt. &vi. 威胁,构成威胁
alarming	adj. 惊人的, 吓人的
astonish	v. 使...惊讶
corporation	n. 公司, 法人, 集团
obsolete	adj. 已废弃的, 过时的
colleague	n. 同事
incline	n. 倾斜, 斜坡, 斜面 v. 使...倾向, 爱好, 易于
include	v. 包括,包含,连...在内 [计算机] 包括
opposition	n. 反对,敌对,在野党
increase	v. 增加, 提高 n. 增加, 增强, 提高
orbital	adj. 轨道的，眼窝的 n. 【数学】轨函数
minority	n. 少数, 少数民族, 未成年
origin	n. 起源,出身,开端
radical	n. 激进份子,原子团,激进派 adj. 急进的,根本的,激进的,基本的,彻底的
commodity	n. 商品, 日用品
acclaim	n. 喝彩, 欢呼, 赞同 v. 欢呼, 喝彩, 称赞
impede	v. 妨碍,阻碍,阻止
manual	adj. 手工的,体力的 n. 手册,指南,键盘
weapon	n. 武器, 兵器
fallacy	n. 谬论
involvement	n. 包含, 缠绕, 混乱, 复杂的情况
constitute	vt. 构成,建立,任命
outline	n. 大纲,轮廓,概要,略图,素描 vt. 描画轮廓,描述要点
variance	n. 不一致, 变化; [数]方差
contamination	n. 污染,污染物
well	n. 井,源泉,楼梯井 adj. 健康的,良好的,适宜的 adv. 很好地,适当地 vi. 涌出 interj. 好吧,啊
institute	n. 学会,学院,协会 vt. 创立,开始,制定
unfamiliar	adj. 不熟悉的
curiosity	n. 好奇, 好奇心
unavoidable	adj. 不可避免的
coordination	n. 同等,调和
tend	vt.照料，照顾； 护理； 照管，管理 vi.倾向（于），趋向（于）； 伺侯，招待； 关心； 注意
installment	n. 分期付款(安装, 一期)
customary	adj. 习惯的, 惯例的
calculator	n. 计算器
exhibition	n. 展览,展览会
damage	n. (pl.)赔偿金,损坏,毁坏 vt. 损害,毁坏
integral	adj. 构成整体所必需的,完整的 n. [数学] 积分, 完整, 部分
introduce	vt. 介绍, 引进, 采用, 提出, 提倡, 放入
vegetation	n. 植物,草木,(植物)生长
wild	adj. 放荡的,未开发的,野生的,原始的 n. 荒野,野生状态 adv. 野性地,未被约束地,偏离预计路线地
sensation	n. 感觉,感知力,激动,轰动
invisible	adj. 看不见的,无形的 n. 隐形人(或物品)
obligatory	adj. 强制性的, 义务的, 必须的
rely	v. 信赖,倚赖,信任
decade	n. 十年
quest	n. 探索,寻求 vt.& vi. 寻找,追寻猎物
claimant	n. 申请者, 要求者, 索偿人
depression	n. 沮丧,萧条
capital	n. 首都,资本,大写字母 adj. 大写的,资本的，首要的
fabric	n. 织物, 布, 结构
carbon	n. 碳,灯芯,复写纸
facility	n.设备； 容易； 能力； 灵巧
discouraging	adj. 令人气馁的 vbl. 使...气馁
assign	v. 分配,指派 n.[计算机] DOS 命令将驱动器符重指向第二个驱动器符
internal	adj. 国内的, 内在的，身体内部的
journalist	n. 记者, 新闻工作者
thrive	vi. 兴旺,繁荣
incentive	adj. 刺激的, 鼓励的 n. 刺激, 鼓励, 动机
lava	n. 熔岩, 火山岩
fruitless	adj. 不成功的, 无结果的
bestow	vt. 授予,适用,利用
inequity	n. 不公平,不公正
nutritious	adj. 有营养成份的,营养的
resemble	v. 相似, 类似, 像
density	n. 密集,密度,透明度
sneer	n. 冷笑, 嘲笑 v. 嘲笑, 冷笑
fancy	n. 想像力, 幻想, 喜好, 爱 adj. 想像的, 时髦的, 华丽装饰的, 奢侈的, 技巧的 vt. 想象, 自认为, 喜好
destructive	adj. 破坏性的, 有害的
legible	adj. 清晰的, 易读的，可辨认的
zoological	adj. 动物(学)的
permanent	adj. 永久的, 持久的 n. (口)烫发
cease	n. 停止 vt. &vi. 停止,终了
distract	vt. 转移,分心
tiny	adj. 极小的,微小的
amiable	adj. 和蔼的, 亲切的
destroy	vt. &vi. 破坏,毁坏 [计算机] 撤消
favour	[英]n. 偏爱；赞同；善行 vt. 赞成；喜爱；有助于
formation	n. 构造,编队,形成
certificate	n. 证(明)书,执照 vt. 批准，认可，发证书给...
federation	n. 联邦, 联合, 联盟
antibiotic	adj. 抗菌的 n. 抗生素
motivate	v. 给与动机,刺激,提高...的学习欲望
tolerance	n. 忍耐力,宽容,容忍,公差
stationery	n. 文具,信笺
chart	n. 图表 vt. 制成图表
fertility	n. 肥沃, 丰饶, 生产力
elapse	v. 逝去, 过去
audience	n. 听众, 观众, 读者, 拥护者, 倾听, 正式会见
luxuriant	adj. 繁茂的, 丰富的, 肥沃的
articulate	adj. 有关节的,发音清晰的 vt. &vi. 以关节连接,接合,明白地说
cognition	n. 认识, 认识力, 知觉
elevate	vt. 举起,提拔,素养提升，鼓舞 vi. 变高
avert	vt. 转开,避免,防止
industrialise	v. (使)工业化 =industrialize(美)
relative	adj. 相对的,比较的,涉及到的 n. 亲属,同类事物,相关物
specialisation	n. 专门, 专业化 =specialization(美)
aware	adj. 知道的, 意识到的
advantageous	adj. 有利的，有助的，有益的
endorse	vt. 背书；认可；签署；赞同；在背面签名
revoke	vt. 撤回(回想) n. 取消(回想)
enhance	vt. 提高,加强,增加
discharge	vt. &vi. 放出,解雇,放电,解除, 清偿债务 n. 释放，卸货，放电，一股，一阵，开火，发射，准许离开
lexical	adj. 字典的, 语句的
stressful	adj. 紧张的, 压力重的
purchase	n. 购买, 购买的物品 n. 支点; 紧握, 抓紧 vt. 购买, 赢得; (用设备)举起, 移动
certify	vt. 证明,保证,证实,颁发证书
monopoly	n. 垄断,专利, 独占，控制
optics	n. 光学
applause	n. 鼓掌, 喝彩, 赞许
diverse	adj. 不同的,相异的,多种多样的
sociologist	n. 社会学家
policy	n. 政策, 方针, 保险单
distinction	n. 区别; 卓越; 殊荣
political	adj. 政治的, 政党的, 派系斗争的, 有政治头脑的
subsidy	n. 补助金, 津贴
populace	n. 平民, 大众
consensus	n. 共识，一致，合意 n. [生理]交感
starve	v. 使饿死, 饿得要死
invaluable	adj. 无价的
population	n. 人口
contaminate	vt. 弄脏,污染
prescription	n. 药方, 对策, 开处方
status	n. 地位, 身份, 情形, 状况
fluid	adj. 流畅优美的,流体的,流动的,不稳定的 n. 流体,液体
niche	n. 壁龛；合适的职业；商机，有利可图的市场(或形势等)； vt. 放入壁龛
ultimately	adv. 最后,最终
crucial	adj. 关键的,决定性的
potential	adj.潜在的，有可能的； [语法学]可能语气的，表示可能性的； 有能力的 n.潜力，潜能； [物]电位，势能； 潜能的事物； [语]可能语气
degenerate	adj. 堕落的 v. 退化, 堕落 [计算机] 退化
disapprove	v. 不赞成
reverse	n. 相反; 背面; 失败, 挫折 adj. 反面的, 相反的, 颠倒的 v. 颠倒, 逆转, 倒退
naturalism	n. 自然，自然主义
pasture	n. 牧场 v. 吃(草) vt. 放牧
lead	n. 铅, 领引, 榜样 v. 引导, 带领, 以铅接合; 过...(的生活)
blight	n. 枯萎病 n. 导致破坏的因素 v. (使）枯萎
combination	n. 结合,联合，联合体
psychic	adj. 灵魂的, 精神的, 心灵的, 通灵的 n.通灵的人
store	n. 商店,贮藏,仓库 vt. 储存,贮藏,供给,保存 adj. 储备的 (在计算机里)存贮；记忆
optimism	n.&amp;adj. 乐观,乐观主义
ominous	adj. 预兆的,不祥的
inductive	adj. 归纳的,动人的 adj. [电]感应的
donor	n. 捐赠人 [计算机] 施主
press	vt.压，按； 逼迫； 紧抱 vi.压； 逼迫； 重压 n.强迫征兵； 新闻报道，出版物； 压榨； 印刷机（厂）
elite	n. 精华, 精锐, 中坚份子
formulate	vt. 规划；用公式表示；明确地表达
influenza	n. 流行性感冒
labor	n. 工作, 劳动, 劳力, 劳方 vt. 苦干, 劳动, 分娩, 阵痛, 致力于 vi. 过分详尽阐述 adj. 劳工的, 劳动的
immense	adj. 巨大的,广大的,非常好的
principal	adj. 主要的 n. 负责人, 校长, 资本
theft	n. 偷窃
impose	vi. 利用；欺骗；施加影响 vt. 强加；征税；以…欺骗
union	n. 联盟,结合,政党,工会,连接轴 adj. 联邦政府的,工会的
anxiety	n. 焦虑,挂念,担心,渴望,热望
observer	n. 观察者
validity	n. 有效性,正确性,正当
product	n. 产品,成果,乘积
comparison	n. 比较
congestion	n. 混杂,拥挤,过剩 [计算机] 拥挤
glossary	n. 字典,辞典 [计算机] 词汇表
occurrence	n. 发生,事件,发现
project	n. 工程,项目,计划,事业 v. 计划,设计,表达 v. 投射,放映,凸出
suffer	vt. 遭受,忍受,允许 vi. 忍受,经历
comprehensive	adj. 综合的, 广泛的, 理解的
proof	adj. 防...的,耐...的,能防护 n. 校样,证据,证明 vt. 检验,给...做防护措施
broaden	v. 变宽, 伸广
fuel	n. 燃料,木炭 vt. 供以燃料 vi. 加燃料
ash	n. 灰, 灰烬
earnest	n. 真诚,重要的东西,定金,保证 adj. 真诚的,重要的
gaunt	adj. 憔悴的, 荒凉的
logic	n. 逻辑(学),逻辑性,合理的推理
conduct	n. 行为, 举动, 品行 v. 引导, 指挥, 管理 vt. 导电, 传热
plateau	n. 高原;平稳;稳定状态 vi. 到达平稳阶段
grassy	adj. 绿色的 像草的
continuous	adj. 连续的, 继续的, 连绵不断的
publish	vt. 出版,发行,公开发表 vi. 出版,发行
edition	n. 版, 版本
efficient	adj. 效率高的,有能力的
accent	n. 重音,口音,强调 vt. 重读,强调
conscious	adj. 神志清醒的,意识到的,自觉的,有意的 n. 意识
access	n.入口，出口； 接近，进入； 增长； 爆发 vt.接近，进入； 使用，接近，获取
generate	vt. 产生,发生,引起 [计算机] 产生
wholesome	adj. 有益健康的, 合乎卫生的, 健全的
conservation	n. 保存, 防止流失, 守恒, 保护自然资源
intricate	adj. 复杂的,错综的,缠结的,难懂的
succession	n. 连续, 继承权, 继位
vast	adj. 广阔的,巨大的 n. 浩瀚的太空
purple	adj. 帝王的,紫色的,辞藻华丽的 n. 紫色,皇室,皇权 vi. &vt. 变紫
prevalent	adj. 流行的, 普遍的
commercialise	vt.使商业化 =commercialize(美)
vertical	adj. 垂直的,顶点的,纵向的 n. 垂直物, 垂直的位置
acquire	vt. 占有,获得,取得,学到
perpetual	adj. 永恒的,永久的,一再往复的
settle	n. 有背的长凳 vt. 安放,安顿,解决,决定,付清(欠款) vi. 定居,降落
licence	n. 执照,许可,特许,自由,放纵 vt. 同意,许可
sympathetic	adj. 同情的,共鸣的 n. 交感神经
victim	n. 受害者,牺牲
blase	adj. 对享乐感到厌倦的, 无动于衷的，非常世故的
historic	adj. 有历史意义的
mortify	v. 抑制,苦修,使...悔恨
vision	n. 视觉,先见之明,光景,视力,眼力,幻想，影像 vt. 幻想
philosophical	adj. 哲学的, 冷静的, 哲学上的
cooperate	vi. 合作,协力
garble	vt. 断章取义, 曲解，混淆 n. 断章取义，混淆
volcano	n. 火山
potentiality	n. 可能力,潜在力,可能性
infection	n. 传染, 影响, 传染病
mortality	n. 必死的命运,死亡数目,死亡率
distinguish	vt. 区别,辨认,特别关注 vi. 区别
hypothesis	n. 假设, 猜测, 前提
glare	n. 闪耀光, 刺眼 v. 发眩光, 瞪视
disruption	n. 分裂, 毁坏
conventional	adj. 普通的,常见的,习惯的,常规的
compensate	vt. &vi. 偿还,补偿,付报酬
recession	n. 后退,凹入的地方,不景气
influence	vt. 影响, 感化 n. 影响力, 势力; 影响, 权势 n. 有影响的人(或事物)
ambition	n. 雄心,野心,抱负,精力 vt. 有...野心,追求
essential	adj.基本的； 必要的； 本质的； 精华的 n.必需品； 基本要素； 必不可少的东西
ridiculous	adj. 可笑的；荒谬的
refinery	n. 精练厂
physiological	adj. 生理的, 生理学的
phenomena	n. 现象
cultivation	n. 教化, 培养, 耕作
confusing	adj. 使人困惑的, 令人费解的 动词confuse的现在分词
sedimentation	n. 沉淀，沉降
overcome	vt. 战胜,克服,(感情等)压倒, 使受不了 vi. 获胜, 赢
recognize	vt. 认出,认可,承认,意识到,表示感激
revive	vt. 使重生,恢复精神,重新记起,唤醒 vi. 复生
feign	vt. 假装，捏造 vi. 假装, 装作
sensitive	adj. 敏感的,灵敏的,易受伤害的,感光的,善解人意的  n. 敏感的人
mathematics	n. 数学
curious	adj. 好奇的,古怪的
indigenous	adj. 该土地所固有的,土著的,国产的
exception	n. 除外,例外
gradual	adj. 逐渐的, 逐步的
pack	n. 包裹,一群,一副,一帮,一群 vt. 包装,捆扎,塞满, 收拾行李， 佩戴 vi. 包装，（用某物）保存，保藏 ,塞进
symbol	n. 符号, 标志, 象征
candid	adj. 忠实的, 率直的, 坦诚的
euphemism	n. 婉言, 委婉的说法
therapy	n. 疗法,治疗
preference	n. 偏爱,优先,喜爱物
measurement	n. 测量,衡量,尺寸,大小
exhibit	n. 展览品,展览,物证 vt. 展览，展现，显出(感情或品质),提出证据 vi. 展览
pane	n. 窗玻璃, 方框, 方格 v. 嵌窗玻璃
damp	n. 毒气,湿气,丧气 adj. 潮湿的 vt. 呛,抑制,使潮湿 vi. 衰减
gravity	n. 地心引力,重力,严重,庄重,严肃
responsive	adj. 回答的, 应答的, 易感应的
virile	adj. 男性的, 男的, 有男子气概的, 精力充沛的
explanation	n. 解释, 说明
depletion	n. 消耗,罄尽,放血
interfere	vi. 妨碍,冲突,干涉
canal	n. 运河,沟渠,气管,食管 vt. 建运河,疏导
merchant	n. 商人,店主,专家 adj. 商业的
whaling	n. 捕鲸(业) 动词whale的现在分词形式
thief	n. 贼,小偷
solar	adj. 太阳的,太阳能的
detachment	n. 分离，分遣，冷漠，公正
render	vt. 使成为, 提供, 报答, 着色; 执行, 实施 vi. 给予补偿 n. 交纳, 粉刷, 打底
ambiguous	adj. 模棱两可的
assume	vt. 假定, 设想, 承担; (想当然的)认为
simultaneous	adj. 同时发生的,同步的
diagnose	v. 诊断 vi. 判断,诊断(疾病) vt. 诊断(疾病)
adolescence	n. 青春期
refrain	n. 重复, 叠句, 副歌 v. 节制, 避免, 克制
delicate	adj. 细致优雅的,微妙的,美味的 adj. 淡色的,淡味的 adj. 娇弱的,纤细的
democratic	adj. 民主的, 大众的, 平等的
residence	n. 住处, 住宅, 居住
departure	n. 离开,出发,分歧
precedent	adj. 在前的,在先的 n. 先例,前例
dam	n. 水坝 vt. 筑坝,抑制(情感）等
resolve	n. 决定之事,决心,坚决 vt. 决定,解决,分离,表决 vi. 分离,决定
respective	adj. 各自的, 分别的
fascinating	adj. 迷人的
regular	adj. 有规律的,有规则的,整齐的,正规的
sort	n. 种类,样子,态度 v. 分类,整理,排序 n.[计算机] DOS命令 : 在字符型文件中进行数据排序, 或者将DOS命令的输出进行排序
dominant	adj. 占优势的，主导的，显性的 n. 主宰者
determination	n. (正式)决定,规定,决心,测定, 定位
feasible	adj. 可行的,可能的
spite	n. 恶意, 怨恨 vt. 刁难, 伤害
attach	v. 附上, 系上, 贴上, 使依恋
reveal	vt. 显示, 透露 n. (外墙与门或窗之间的)窗侧, 门侧 n. (汽车的)窗框
scenery	n. 布景,风景,背景
characteristic	adj. 特有的, 典型的 n. 特性, 特征, 特色
economics	n. 经济学
accredited	adj.被认可的，可接受的，委任的 动词accredit的过去式和过去分词
specific	adj. 特殊的, 明确的, 具有特效的 n. 特效药, 特性, 详情
poignant	adj. 悲伤的,痛切的，严厉的, 尖锐的, 剧烈的，浓烈的
linguist	n. 语言学家
extraordinary	adj. 非凡的,特别的,特派的
accessory	adj. 附属的(副的,辅助的) n. 附件，同谋
merchandise	n. 商品,货物 vt. &vi. 经营,推销, 销售, 经商
syllabus	n. 摘要,课程表
arrogant	adj. 傲慢的, 自大的
rival	n.对手； 竞争者 vt.与…竞争； 比得上某人 vi.竞争 adj.竞争的
trace	n. 痕迹,踪迹,微量 vt. 追踪,找出根源,描绘 vi. 追踪
assail	vt. 猛烈攻击，言语抨击
affirm	vt. 证实,断言,肯定 vi. 断言,申明
socialise	v. 来往，交往，交际，（使)社会化 =socialize(美)
string	n. 线,一串,字串 vt. 串起,成串,收紧, 悬挂；系；扎 vi. 给…装弦 adj. 线的
tradition	n. 传统, 惯例
suitcase	n. 手提箱
applicant	n. 申请人
attest	v. 证明, 作证, 为...作证
transfer	n. 迁移, 移动, 换车 v. 转移, 调转, 调任
equivalence	n. 相等, 等值
escalate	vt. 扩大,升高,增强 vi. 逐步升级
dispose	vt. 倾向于,处置 vi. 销毁
dispute	n. 争论; 争吵 vi. 争论, 争执 vt. 争论; 质疑; 争夺; 抵抗
evasive	adj. 逃避的,回避的,托辞的
futile	adj. 无效的, 无用的
conduction	n. 传导
flood	n. 洪水,水灾 v. 淹没,溢出 vi. 大量涌到,泛滥 vt. 灌溉,淹没
assert	vt. 主张,声明,断言
fragile	adj. 易碎的,脆的,精细的
statistical	adj. 统计的, 统计学的
negligent	adj. 疏忽的, 粗心的, 不在意的
accountant	n. 会计人员
notify	v. 通知,通告,报告
unanimous	adj. 全体一致的, 一致同意的
account	n.账，账目； 存款； 记述，报告； 理由 vi.解释； 导致； 报账 vt.认为； 把…视作
dissent	n. 异议 v. 持异议
patterning	n. 制作布线图案(集成电路的图案形成)
hostile	adj. 怀敌意的,敌对的
fabulous	adj.极好的，极妙的； （美貌）惊人的； 寓言般的； 难以置信的
practical	adj. 实际的,实用的,明智的 n. 实践考试
communicative	adj. 健谈的，爱说话的, 畅谈的
issue	n. 问题；流出；期号；发行物 vt. 发行，发布；发给；放出，排出 vi. 发行；流出；造成…结果；传下
pseudonym	n. 匿名, 假名, 笔名
preferable	adj. 更好的, 更合意的
fluctuation	n. 波动,起伏
commitment	n. 委托,实行,承诺,保证(律）拘禁令，奉献，献身
identify	vt.识别，认出； 确定； 使参与； 把…看成一样 vi.确定； 认同
ultimate	n. 终极,根本，精华 adj. 终极的,根本的,极限的,最后的
ignore	vt. 不顾,不理,忽视
hierarchical	adj. 按等级划分的
drift	n. 漂移,漂流物,观望,漂流,吹积物,趋势 vi. 漂移,漂流,吹积 vt. 使漂流,把...吹积
imitate	v. 模仿 vt. 仿制,仿造,模仿,仿效
intension	n. 加强，强度 [逻]内涵
collector	n. 收集家, 收税员
particulate	n. 微粒子，微粒状物质 adj. 微粒的
unit	n. 单位, 单元
produce	n. 产品, 农作物 vt. 生产, 提出, 引起, 分娩, 制片 vi. 生产, 制造
profit	n. 利润, 盈利比率，利益 vi. 利用，获利 vt. 有益于
duration	n. 持续时间，期间
notification	n. 通知单,通告,告示 [计算机] 通知
sufficient	adj. 足够的, 充分的
virtual	adj. 虚拟的；有效的；实质上的，事实上的
prejudice	n. 偏见,成见,伤害 v. 使...存偏见,使...有成见,伤害
seed	n. 种子 vi. (植物)结实,播种 vt. 播种
implore	v. 恳求, 哀求
block	n.块； 街区； <英>大楼，大厦； 障碍物，阻碍 vt.阻止； 阻塞； 限制
concept	n. 概念, 观念
selection	n. 选择,挑选,挑选出来的人或事
heritage	n. 遗产, 继承物
provide	vi. 供给, 提供 vt. 提供; 规定; 准备
genetics	n. 遗传学
support	n. 支持, 援助, 供养 vt. 支援, 帮助, 支持
eruption	n. 爆发,喷发，出疹，长牙
penalize	v. 处刑, 宣告有罪, 处罚，使不利
habitual	adj. 惯常的, 习惯的
immune	adj. 免除的,免疫的 n. 免疫者
separation	n. 分离, 分居, 缺口
value	n. 价值, 重要性, 价格, (pl)价值观 vt. 评价, 估价, 重视
retailer	n. 零售商(店)
consequently	adv. 所以, 因此
genius	n. 天才, 高智力, 天赋
administrator	n. 管理人,行政官
release	n. 释放, 让渡, 发行 vt. 释放, 让与, 准予发表, 发射
elementary	adj. 基本的,初级的,元素的
accustomed	adj. 习惯了的,通常的
quarrel	n. 吵架,争论,怨言 vi. 吵架,争论,挑剔
pressing	adj. 紧迫的,紧急的,切实的 vbl. 压迫
migration	n. 移民,移往,移动
harass	v. 使...困扰,使...烦恼,反复袭击
prolong	vt. 延长,拖延
administration	n. 行政,管理,中央政府
employer	n. 雇主
advanced	adj. 高级的, 先进的
defend	vt. &vi. 防护,辩护,防卫
optical	adj. 眼睛的, 视觉的, 光学的
optimistic	adj. 乐观的, 乐观主义的
quotation	n. 1．引语,语录  2．报价单  3．行情表
nutrient	adj. 营养的,滋养的 n. 营养物,营养品
volume	n. 体积, 容量, 音量 n. 卷, 册
shift	n. 交换,变化,移动,接班者 vt. 更替,移转,变声 vi. 改变,定责,更衣
radiation	n. 辐射,放射线
radio	n. 收音机,无线电 vt.& vi. 用无线电通讯
esteem	n. 尊敬 vt. 认为,尊敬
organ	n. 风琴,器官,机构,机关报刊
humiliate	v. 使...丢脸,使...蒙羞,屈辱
glance	vi.一瞥； 闪微光； 掠过，擦过； 随便提到，简略地触及 n.浏览； 闪光； 歪斜，一掠
random	n. 随意,任意 adj. 任意的,随便的,胡乱的 adv. 随机地
introvert	n. 个性内向者 vt. 使...内向
range	n.范围； 射程； 类别； （山脉，房屋等的）排列 vi.搜索； 变化； 延伸； 漫游 vt.排列； （按一定位置或顺序）排序； 把…分类； 徘徊 adj.牧场的，放牧区的
equality	n. 同等, 平等
burden	n. 负担, 重载 v. 使负重, 装载, 烦扰
completion	n. 完成,完满
inferior	adj. 次等的, 较低的, 不如的
rational	adj. 合理的,理性的,能推理的 n. 有理数
recreation	n. 消遣, 娱乐
generally	adv. 一般地
conception	n. 概念,观念,构想,怀孕
critic	n. 批评家, 评论家
critical	adj.批评的，爱挑剔的； 危险的，危急的； 决定性的； [物]临界的
criticism	n. 批评,评论
significant	adj. 有意义的, 意味深长的; 相当数量的; 重要的, 重大的 n. (复)有意义的事物; 标志
insert	n. 插入物 vt. &vi. 插入
inclination	n. 倾向, 意愿, 倾斜度
inspection	n. 检查,视察
simplicity	n. 单纯, 简朴
incredible	adj. 难以置信的, 惊人的
convenience	n. 适宜，便利, 便利设施，方便的时间，舒适
erroneous	adj. 错误的, 不正确的
institution	n. 机构,惯例,创立
correspondence	n. 通信；一致；相当
instruction	n. 说明,须知,指令,教学
stationary	adj. 不动的(稳定的) n. 固定物(驻军)
examine	vt.检查，调查； 考试； 诊察； 审问 vi.检查； 调查
temper	n. 脾气；（钢等）回火；性情；倾向 vt. 使回火；锻炼；调和；使缓和 vi. 回火；调和
exceed	vt. 超过, 胜过, 超出界限 vi. 领先
mature	adj. 成熟的, 到期的, 充分发育的, 考虑周到的 vt. 使...成熟, 长成 vi. 长成, 成熟; 到期
panel	n.镶板； 面； （门、墙等上面的）嵌板； 控制板 vt.选定（陪审团）； 把…分格； 在…上置鞍垫； 把…镶入框架内
intense	adj. 非常的,强烈的,紧张的,热情的
initiative	adj. 创始的, 初步的, 自发的 n. 第一步, 首创精神; 主动权
tendency	n. 趋势,倾向
mean	n.平均值, 平均数; 中部 adj. 低劣的, 卑贱的; 卑鄙的; 吝啬的 adj. 平均的, 中等的 v. 意味, 想要, 意欲
database	n. 数据库
refute	vt.驳斥，驳倒； 否认真实性
infringe	v. 破坏, 犯, 违反
exist	v. 存在
gratitude	n. 感谢的心情
severity	n. 严格, 严重, 激烈
innate	adj. 天生的,固有的
demise	n. 死亡,转让房产,让位 vt. 让渡,遗赠,转让 vi. 遗赠,死亡
expectation	n. 期待,期望 v. 期待,前程
declaration	n. 宣布, 宣言
slight	n. 轻蔑 adj. 轻微的,纤细的,脆弱的 vt. 轻视,忽略
sadistic	adj. 虐待性变态症的,残酷成性的
adjacent	adj. 毗连的,邻近的,接近的
stimulus	n. 刺激, 激励, 刺激品
provision	n. 规定, 条款; 供应(品); 预备 n. (pl.) 食物 vt. 向...供应食物
offspring	n. 子孙, 后代, 产物
methodical	adj. 有方法的,有系统的
cancel	n. 取消,撤消 vt. 取消,删去, 约分 vi. 抵消
ale	n. 麦芽酒, 乡下啤酒节
deliberate	adj. 故意的,深思熟虑的, 从容不迫的 vi. 仔细考虑 vt. 研讨
remark	n. 备注,评论,注意 vt. 评论,注意,述及
predictor	n. 预言者
supervise	vt. 监督,管理,指导
factor	n. 因素,因子 vt. 把…因素包括进去 vi.作为因素
portfolio	n. 文件夹，作品集，证券投资组合
bacterial	adj. 细菌的
deviation	n. 偏差数, 偏离，出轨，背盟
economy	n.节约； 经济； 理财； 秩序
superb	adj. 极好的
procrastinate	v. 延迟, 迁延, 耽搁
ambiguity	n. 不明确,含糊,暧昧,模棱两可
judge	vt.& vi.审判，评判； 断定 vt.估计； 评价； （尤指）批评； 想，认为 n.法官； 裁判员； 评判员； 鉴定人
handle	n. 柄,把手 vt. 买卖,处理,操作 vi. 驾驭
extrovert	n. 性格外向的人 =extravert
deliver	vt.发表； 递送； 交付； 使分娩 vi.投递； 传送
ritual	n. 仪式,典礼,宗教仪式,固定程序 adj. 仪式的,依仪式而行的，老规矩的，惯常的
reservoir	n. 水库,蓄水池,积蓄,储藏
reflex	n. 反射(映象,回复,习惯性思维) adj. 反射的(来复的)
ecological	adj. 生态的, 生态学的
dispatch	n. 派遣；急件 vt. 派遣；分派
grateful	adj. 感激的, 感谢的
depress	vt. 使...沮丧,按,降低 [计算机] 降低
resort	n. (渡假)胜地, 手段, 凭借 vi. 诉诸, 常去
respond	vi. &vt. 回复,反应，响应，应答 n. 拱柱
respectful	adj. 表示尊敬的, 有礼貌的, 谦恭的
obsession	n.[U]痴迷；困扰,成见  [C]使人痴迷的人（或物）
disturbance	n. 扰乱,骚动
cell	n. 细胞, 电池, 小组, 小房间, 单人牢房, (蜂房的)巢室, 手机
title	n. 头衔,名称,标题,所有权,资格,冠军 vt. 赋予称号,加标题于 adj. 标题的
antagonist	n. 敌手, 对手，[医]对抗剂,[生理]对抗肌
adjustment	n. 调整
carbolic	adj. 碳的, 用煤焦油制成的
unify	v. 统一,使成一体
federal	adj. 联邦的 n. 同盟盟友
dialect	n. 方言
analyze	v. 分析,分解 vt. 分析
fetal	adj. 胎儿的,胎的
difference	n. 差异,分歧 vt. 引起区别
fiber	n. 纤维(物质),力量
socialize	vt. 使...社会化，使...社会主义化，使适应社会需要 vi. 交际
gallery	n. 美术馆, 画廊, 顶层楼座, 狭长的房间
spin	n. 旋转, 疾驰 v. 纺织, 旋转, 拉长
studio	n. 工作场所,画室，照相室，制片厂
diligent	adj. 勤奋的, 用功的
dimension	n. 尺寸, 次元, 容积, 维度 n. 范围; 方面 vt. 标尺寸; 形成...尺寸
photosynthesis	n. 光合作用
misinterpret	v. 误解
mining	n. 采矿, 矿业
brochure	n. 小册子
brutal	adj. 野蛮的,残暴的
merge	vt. &vi. 合并,消失,吞没, 融合 [计算机] 合并
collaborative	adj. 协作的,合作的
alternate	adj. 交替的, 轮流的, 间隔的 vt. &vi. 交替, 轮流
concise	adj. 简明的, 简要的
module	[计算机] 模块 n. 组件
transmission	n. 传输, 播送, 变速器, 传递的信息
stage	n. 阶段,舞台,驿站 v. 上演,表演,乘驿车旅行
fluency	n. 流利，流畅
behave	vt. &vi. 举止,行为,举止端正
hire	vt.聘用； 录用； 雇用； 租用 vi.受雇； 得到工作 n.租金； 酬金，工钱； [非正式用语] 被雇佣的人； 销售部的两个新雇员
signification	n. 意义，示意，重要性
classification	n. 分类,分级
classify	v. 分类,归类,分等
exploration	n. 探险,踏勘,探测
standard	n.标准，规格； 旗，军旗； 度量衡标准； 直立支柱 adj.标准的，合格的； 普遍的，一般的； 公认为优秀的
proponent	n. 建议者,支持者
mundane	adj. 世俗的，平凡的；世界的，宇宙的
succinct	adj. 简洁的 adj. [古]紧身的
exhaustive	adj. 无遗漏的, 彻底的, 详尽的
assumption	n. 假定,设想,担任(职责等),假装
exotic	adj. 异国的,外来的,奇异的,脱衣舞的 n. (复数)异国风格的事物,脱衣舞者
cooperation	n. 合作, 协作
automate	v. 自动化 vt. 使自动化
nocturnal	adj. 夜的 n. 夜间时刻测定器
coherent	adj. 互相耦合的,清晰的，明了的，凝聚性的,连贯的
sincere	adj. 真诚的, 诚挚的
domestic	adj. 国内的, 家庭的, 驯养的 n. 家仆, 佣人
hypothesize	v. 假设, 假定, 猜测
admire	vt. 钦佩, 羡慕, 赞美
advance	n. 前进,进步,预支 vt. 前进，增涨，预先 vi. 前进，提升 adj. 预先的，提前的
precaution	n. 预防,留心,警戒
ire	n. 忿怒 vt. 使发怒
donate	vt. 捐赠,转移(电子) vi. 捐款
transaction	n. 交易,处理,办理
identical	adj. 相同的,同一的
station	n. 车(站),位置,姿势,地位 vt. (配)安置
instalment	n. 分期付款,（连载作品或分集戏剧等的）一部分，一集=installment(美)
pretend	vt. &vi. 假装,伪称 adj. 假装的,赝品的,模拟的
scatter	n. 散布, 零星少量 vt. 驱散, 散播 vi. 分散, 消散
primary	n. 最主要者 adj. 主要的, 初期的, 根本的
panic	n. 恐慌,惊惶 adj. 惊慌的,没有理由的,恐慌的 vt. 使...惊慌
immediately	adv. 立即,直接地 conj. 一...(就)
economic	adj. 经济学的, 经济的，有利可图的 n. [-s]经济学(状况等)
unemployment	n. 失业,失业人数
transcript	n. 成绩单 n. 抄本,誊本;副本 n.笔录
participant	adj. 参与的 n. 参加者,参与者
prior	adj. 更重要的, 较早的, 在先的 adv. 居先 n. 小修道院院长; 大修道院副院长
betray	vt. 误导,出卖,背叛,泄露 vi. 证明...错误
frank	adj. 坦白的,直率的,无误的 vt. 免费邮寄,使自由出入 n. 免费邮寄
chaos	n. 混乱
communist	adj. 共产主义的 n. 共产主义者
observe	v. 观察, 遵守, 注意到
devastate	vt. 毁坏,使震惊
competition	n. 比赛,竞争
perception	n. 感知, 认识, 观念
progressive	adj. 前进的, 渐进的 n. 进步人士
promise	n. 诺言, 约定, (有)希望，预示 v. 允诺, 约定, 预示, 有可能
compound	n. 混合物,复合词 adj. 复(混)合的,合成的 vt. 混合,调合,妥协 vi. 混合,妥协
personalise	vt. 使个人化，拟人化 =personalize（美）
ecstatic	n. 狂喜的人 adj. 狂喜的
supplier	n. 供应者, 供应厂商, 供应国
mercenary	adj. 唯利是图的，雇佣的 n. 唯利是图的人，雇佣兵
concentrate	vt.& vi.专心于； 注意； 集中； 聚集 vt.浓缩，（使）浓缩； [采矿]汰选； 选矿，精选，富集 vi.凝缩，浓缩，提纯 n.浓缩物 adj.集中起来的，经过浓缩的
contradiction	n. 反驳,矛盾,不一致,否认
select	adj. 精选的 n. 被挑选出来的人或物 v. 选择 vi. 选择,挑选,选拔 vt. 选择,挑选
carve	vt.& vi. 雕刻,切割
realisation	n. 实现，认识 =realization(美)
hinder	adj. 后面的 vt. 阻碍,打扰 vi. 阻碍
confident	adj. 确信的, 自信的
border	n. 边缘 vt. 作...之疆界,加边
destiny	n. 命运
elation	n. 得意洋洋, 兴高采烈
elective	adj. 选举的，随意选择的 n. 选修科目
valuable	adj. 贵重的, 有价值的 n. (pl.)贵重物品
suspect	vt.猜疑（是）； 怀疑，不信任； 怀疑…有罪 n.嫌疑犯 vi.怀疑
accommodation	n. 住处，膳宿；调节；和解；预订铺位
transference	n. 调任，转移，转让，移情
accomplish	vt. 完成
session	n.开会，会议；（法庭的）开庭； 会期，学期； （进行某活动连续的）一段时间
purify	v.(使）净化，（使）精炼，涤罪
wonder	n. 惊奇；奇迹；惊愕 vi. 怀疑；想知道；惊讶 vt. 怀疑；惊奇；对…感到惊讶 adj. 奇妙的；非凡的
constrict	v. 压缩, 束紧, 使收缩
prey	n. 被掠食者,牺牲者 vi. 捕食,掠夺,使...苦恼
gullible	adj. 易受骗的，轻信的
loyal	adj. 忠诚的,忠心的 adv. 忠诚地,忠实地 n. 忠贞,忠诚,忠实
discouragement	n. 挫折
exploitative	adj. 开发的，利用的，剥削的
emit	v. 发出,放射,吐露 [计算机] 发射
contract	n. 合约, 婚约; 合同书 v.签合同； 缩小； 感染
emotional	adj. 感情的, 情绪的
emphasis	n. 强调,重点
criterion	n. 标准, 准则
terminal	n. n. 终端机,终点,末端 adj. 终点的,晚期的,致死的
quality	n. 品质, 特质, 才能 adj. 高品质的
admission	n. 许可, 入会费, 承认
conducive	adj. 有助于...的
vivid	adj. 生动的,强烈的,鲜艳的,清晰的,逼真的
motorist	n. 驾车旅行的人，开汽车的人
optional	adj. 可以任选的,非强制的
voluntary	adj. 自愿的, 志愿的 n. (教堂礼拜仪式前后或进行期间的)乐器独奏
engineer	n. 工程师 v. 设计,制造 vt. 操纵,设计,建造
depict	vt. 描述,描绘
corresponding	adj. 符合的, 一致的, 相同的, 相应的, 相当的
agriculture	n. 农业
order	n.命令； 秩序； 规则，制度； 次序 vt.命令； 订购； 整理 vi.下订单
luxurious	adj. 奢侈的, 豪华的
rapport	n. 关系, 同意, 一致
pharmaceutical	adj. 药物的(医药的) n. 药品(成药)
envy	vt. &vi. 嫉妒,羡慕 n. 妒忌,羡慕
rate	n. 比率, 等级, 价格 vt. 估价, 认为, 定等级; 责骂 vi. 受欢迎, 受推崇; 责骂
complexity	n. 复杂，复杂性, 复杂的事物
altitude	n. 高度,海拔,高地
irate	adj. 发怒的, 生气的
reduction	n. 减少,缩小, (化学)还原反应, (数学)约分
situation	n. 位置, 形势, 局面, 处境, 状况, 职位
equity	n. 权益，产权，(无固定利息的)股票 n. 公平, 公正
similar	adj. 相似的,类似的,相同,一样
context	n. 上下文, 环境,背景
photography	n. 摄影术
contradict	vt. 反驳,与...矛盾
evident	adj. 明显的, 明白的
induce	vt. 引诱,导致,催生
cubic	adj. 立方体的
characterise	vt. 表示 ... 的特征，描述 ... 的特征 =characterize（美）
thread	n. 线,纤维,思路,线索, 螺纹 vt. 穿线于,穿过,成线, 遍布 vi. 小心地通过, 蜿蜒前进, 滴下成丝状
completely	adv. 完全地, 十分地, 全然
predatory	adj. 掠夺的, 掠夺成性的, 捕食生物的
intellectual	n. 有知识者,知识份子,凭理智做事者 adj. 智力的,知性的,聪明的
wheel	n. 轮子,周期,旋转运动 vi. 旋转,转动 vt. 推或拉车,传送,打圈,装以车轮
courteous	adj. 有礼貌的，殷勤的
excess	adj. 过量的,附加的 n. 超过,超越,过度,过量
application	n.适用，应用，运用； 申请，请求，申请表格； 勤勉，用功； 敷用，敷用药
replication	n. 复制
innovation	n. 创新, 革新
judicial	adj. 法庭的, 公正的, 审判上的
inspiration	n. 灵感,吸入,鼓舞人心(的东西)
engineering	n. 工程(学),工程技术
arbitrary	adj. 任意的, 专制的, 武断的, 霸道的
region	n. 地区,地域,地带,行政区
slavery	n. 奴役，奴隶制，奴隶身份
regulation	n. 规则, 规章, 管理 adj. 规定的, 官方的
temperate	adj. 温和的, 适度的, 有节制的
generalise	v. 使一般化，概括 =generalize（美）
sensitivity	n. 敏感, 多愁善感, 感受性
deficient	adj. 不足的, 不充分的, 有缺陷的
pollutant	n. 污染物质
intercede	v. 仲裁, 说项
isolate	adj. 孤立的 v. 隔离,孤立 vt. 使隔离,使孤立
natural	adj.自然的； 物质的； 天生的； 不做作的 n.自然的事情； （生来的）白痴； [乐]（风琴等的）白键
contribution	n. 贡献,捐款(赠)
denounce	v. 告发, 公然抨击
metal	n. 金属,质料 adj. 金属制的 v. 以金属覆盖
definitive	adj. 决定性的，权威性的，确定的，限定的 n. 限定词
saturate	v. 使渗透, 浸, 使饱和 adj. 浸透的, 饱度高的, 深颜色的
symbolic	n. 代号 adj. 象征的, 符号的
remote	adj. 偏僻的,遥远的,远程的，(感情等)距离很大 n. 远程操作
captive	n. 俘虏, 迷恋者 adj. 被俘的, 被迷住的
capture	n. 抓取,战利品,捕获之物 vt. 抓取,获得,迷住
confidence	n.信心； 信任； 秘密
renew	vt. 使更新,复始,使恢复,补充 vi. 更新,重新开始
assess	v. 估定, 评定
predation	掠夺行为
residential	adj. 住宅的,与居住有关的
mineral	adj. 矿物的 n. 矿物, 矿石
jeopardize	vt. 危害,使受危困,使陷危地
reproduce	v. 再生, 复制, 生殖
require	v. 需要, 要求
infuriate	adj. 狂怒的 v. 激怒
affluent	adj. 富裕的 n. 支流；富人
urbanisation	n. 都市化，城市化 =urbanization(美)
solution	n. 解答, 解决办法, 溶解, 溶液
scout	n. 童子军,侦察员, 守卫 vt. 侦察, 物色人才 vi. 寻找, 物色
elasticity	n. 弹力, 弹性
dependent	adj. 附属的,依赖的,悬垂的 n. 受经济援助者
linear	adj. 直线的，线性的，长度的
derive	v. 得自, 起源, 引申于
distortion	n. 扭曲, 变形, 曲解
animosity	n. 憎恶, 仇恨
lenient	adj. 宽大的, 仁慈的
dismiss	vt.解雇，把…免职； 遣散，解散（队伍等）； 驳回，拒绝受理； 搁置 vi.解散
undermine	vt. 暗中损害, 逐渐削弱, 在(某物)下挖洞或挖通道, 从根基处损害
address	n. n.地址； 通信处； 演说； 称呼
irony	n. 反讽, 讽剌, 讽剌之事
charisma	n. 非凡的领导力,教祖般的指导力,神授的能力
athlete	n. 运动员
hazard	n. 冒险,危险,危害 v. 冒...的危险,赌运气
smug	adj. 自以为是的,满漂亮的,俏皮的 n. 书呆子,难以交往的家伙
alleviate	vt. 减轻,使...缓和
furniture	n. 家具
tongue	n. 舌头,语言,口条,语言,说话方式 vt. 舔,闲谈,斥责 vi. 吹乐器
sophistication	n. 老练，精明，复杂，精密，有教养，诡辩, 强词夺理
drama	n. 剧本,戏剧,戏剧性情节,刺激
linguistics	n. 语言学
multiply	vt. 乘,增加 vi. 扩大,繁衍,做乘法 adv. 多样地,多重地
automatic	n. 自动装置, 半自动武器 adj. 自动的,机械的,半自动化的
implicit	adj. 暗示的,盲从的 [计算机] 隐式
reject	n. 被拒之人,不合格品,不及格者 v. 拒绝,驳回,丢弃
adoption	n. 采用, 采纳, 收养
endow	vt. 捐助,赋予,使具有某种品质
enterprise	n. 企业,企划,进取心
invest	vt.& vi.投资； 花费 vt.授予，使就职； 给…穿衣，装饰； 使充满； 覆盖
pleasant	adj. 令人愉快的,舒适的
voter	n. 投票人, 选举人
audible	adj. 听得见的
immunity	n. 免疫, 免疫性, 免除
inevitable	adj. 不可避免的, 必然(发生)的
innovate	v. 改革, 创新
symptom	n. 症状, 征兆
sanctuary	n. 圣所, 耶路撒冷的神殿, 至圣所
sol	n. C大调音阶中的第五音 n. 索尔（秘鲁的货币) n. 溶胶
strong	adj. 强壮的, 牢固的, 坚定的, 坚强的, 强烈的, 浓的
evoke	vt. 唤起,引起
scholarship	n. 奖学金, 学问, 学识
clerk	n. 职员,办事员
negotiate	vt. 转让,越过,处理,协商 vi. 协商
terminology	n. 术语,术语学
assessment	n. 估价, 评估
expansive	adj. 易膨胀的, 易扩张的
attachment	n. 附件, 附著, 附属物, 依恋, 忠诚，依赖 [法律]扣押令
insistence	n. 坚持(强调,坚决主张)
horizontal	adj. 水平的,横的 n. 水平线,水平面
cognitive	adj. 认知的,认识的,有认识力的
surveyor	n. 测量员(检查员)
acid	adj. 酸的 n. 酸, 酸味物质
obstinate	adj. 固执的, 倔强的，不易屈服的，（病）难治的
lament	n. 悲叹, 悔恨, 恸哭 v. 哀悼, 悔恨, 悲叹
innovative	adj. 革新的, 创新的
admit	vt.& vi.许可进入； 承认，供认 vt.允许； 确认 vi.承认； 允许
tropical	adj. 热带的, 炎热的, 热带植物的
humble	adj. 卑下的, 谦逊的, 粗陋的 vt. 使...卑下, 贬低
precious	adj. 宝贵的,珍贵的,矫揉造作的 adv. 极其地
athletics	n. 体育运动，田径
coronary	adj. 冠状的, 冠状动脉或静脉的，心脏的 n.冠状动脉或静脉，冠状动脉血栓形成，心脏病发作
originate	vt. 发起 vi. 开始 [计算机] 起始
manufacture	n. 产品,制造,制造业 vt. 制造,加工 vi. 参与制造
idle	adj. 无目的的, 无聊的; 懒惰的, 闲散的; 无根据的 vt.虚度; 使空闲 vi. 不作事, 闲逛; (机器)空转
fiscal	adj. 财政的,国库的
competence	n. 能力,管辖权,技能
auditory	adj. 听觉的 n. 观众，观众席
scarce	adj. 缺乏的,不足的,稀少的,罕见的 adv. 勉强
image	n. 图像,影像,肖像,想像,形象 vt. 想像,描绘,反映
fruition	n. 结果, 成就, 实现
puncture	n.刺伤；小洞；（尤指皮肤上被刺破的）扎孔 v.在…上扎孔（或穿孔）；（被）刺破；使突然泄气；挫伤（锐气等）
primitive	adj. 原始的 n. 原始人,文艺复兴前的艺术家
opportunist	n. 机会主义者, 投机者 adj. 机会主义者的
evaluation	n. 估价,评价
unique	adj. 独一无二的, 独特的, 稀罕的
commerce	n. 商业, 贸易
commercial	adj. 商业的 n. 商业广告
transcribe	vt.（用不同的录音手段）转录； 抄写，誊写； 改编（乐曲）（以适应他种乐器或声部）
procedure	n. 程序, 手续, 步骤; 常规的做法
community	n. 社区, 团体
unite	v. 联合, 合并, 混合
reasoning	n. 推论, 推理, 论证
transit	n. 经过,运输 vt. 穿越,旋转 vi. 越过
frequent	adj. 经常的,频繁的 vt. 常到,常去
production	n. 生产,产品,产量,作品,成果
apparatus	n. 装置, 器具, 机构, 组织
format	n. 设计,版式 n.[计算机]格式,DOS命令 : 格式化(磁盘),用于空盘或使用过的磁盘建立新空盘来存储数据 v. vt.使格式化,设计,安排
frequency	n.&amp;adj. 频繁,频率
secret	adj. 秘密的,机密的 adv. 秘密地 n. 秘密
progress	n. 进步, 发展, 前进 vi. 促进，进步, 进行
turmoil	n. 骚动, 混乱
component	n. 元件, 组件, 成份 adj. 组成的, 构成的
sibling	n. 兄弟姐妹
dynamic	adj. 动态的, (有)动力的, (有)力的; 有活力的 n. 动力; 力学
persistence	n. 坚持(余辉,时间常数)
personality	n. 个性, 名人, 特色
vocation	n. 职业,行业,职务
suitable	adj. 合适的, 适宜的
arose	arise的过去式
furious	adj. 狂怒的, 猛烈的
logical	adj. 符合逻辑的,逻辑上的,有推理能力的
hesitation	n. 犹豫
protest	n. 抗议, 反对, 抗议书 vi. 反对,抗议,断言 vt. 坚持地表示, 对...提出异议
semester	n. 学期
shrewd	adj. 精明的
utilize	vt. 利用
complain	vi. 抱怨,悲叹,控诉
sense	n. 侦测, 感官, 感觉; 理智; 意义 vt. 感觉, 了解; 检测
bacteria	n. (复数)细菌
general	n. 一般,将军,大体 adj. 一般的,普遍的 v. 指挥,作...将军
purpose	n. 目的, 意图; 意志, 决心; 议题 vt. 打算, 决意
pursuit	n. 追求, 追赶, 工作
consult	v. 商讨,向...请教,查阅
swell	n. 增大,隆起的部分, 波浪 adj. 优秀的, 时髦的 vi. 渐增, 膨胀, 积聚, 情感迸发 vt. 使情感迸发, 扩大, 使膨胀
pseudo	adj. 假的, 冒充的
gruesome	adj. 可怕的, 令人毛骨悚然的, 阴森的
weight	n. 重量,体重,重担 vt. 使...负重, 使倾斜
numeracy	n. 识数，计算能力
waive	vt. 丢弃,免除,推迟,搁置
profitable	adj. 有益的, 有用的
expulsion	n. 驱逐, 开除,排气
breed	n. 品种,族类 vt. 养育,繁殖,引起 vi. 繁殖
promotion	n. 促进,提升,推广
perpetuate	vt. 使永存,使不朽
condescend	vi. 屈尊，俯就，怀着优越感对待
emission	n. 发射, 射出, 发行
operational	adj. 操作的, 运作的
persistent	adj. 固执的,坚持的,连续的
coal	n. 煤, 木炭, 运煤工 vt. 烧成炭,供应煤 vi. 装煤, 加煤
sharp	adj. 刺耳的,锋利的,急剧的 adv. [时刻]正,准 夏普(财富500强公司之一，总部所在地日本,主要经营电子电气)
option	n.选择（的自由）； 选项； 选择权； 选择能力 vt.得到或获准进行选择； 调动球员
nutritional	adj. 营养的,滋养的
accountancy	n. 会计工作，会计学
united	adj. 联合的 v. 联合, 统一 vbl. 统一
questionnaire	n. 调查表
irrigate	vi. 进行灌溉 vt. 灌溉
entire	adj. 全部的,完整的，同性质的，纯正的，全面的
indispensable	adj. 不可缺少的
entrant	n. (参加比赛的)竞赛者, 新就业者, 新成员
herbivore	n. 草食动物
substitution	n. 代理,替换,交换
inspect	vt. 调查, 检阅 vi. 调查
prudent	adj. 谨慎的, 有远见的, 精打细算的
accomplishment	n. 成就,完成
creature	n. 生物, 动物, 人
publicity	n. 公众的注意,宣传,宣扬,宣传品,广告
crime	n. 犯罪, 羞耻, 罪行
pure	adj. 纯的, 纯洁的, 纯理论的, 抽象的, 完全的
silence	n. 沉默,寂静 v. 使沉默,使安静 vt. 使安静,使沉默
insist	vt. 坚持,强调 vi. 坚决主张
simulate	v. 假装,冒充,模仿,模拟
technique	n. 技术
controversy	n. (公开的)争论,争议
anticipate	vt. 预期，期望；占先，抢先；提前使用
crystal	adj. 清澈透明的, 晶体的 n. 水晶, 结晶
induction	n. 就职,感应,归纳法,序言
evolve	vt. &vi. 进展,进化,展开
replicate	vt. &vi. 折叠,复制,模写 n. 同样的样品 adj. 转折的
revolve	vt. &vi. 旋转,考虑,循环
converter	n. 转换器 =convertor
insure	vt. 保险,确保 vi. 买保险
site	n. 位置,场所 v. 使...位于,使...放置
tempt	vt. 诱惑；引起；冒…的风险；使感兴趣
refer	vt. 把…提交; 把...归因, 归类为 vi. 谈及, 咨询, 参考
deceptive	adj. 迷惑的, 虚伪的, 诈欺的
indulgent	adj. 纵容的, 任性的, 宽纵的
ruthless	adj. 残忍的, 无情的
appreciate	vt. 欣赏,感激,赏识 vt. 领会，充分意识 vi. 增值
retrieve	vt. 挽回,恢复,回忆,补偿 vi. 找回猎物 n. 取回,恢复
grant	vt.承认； 同意； 准许； 授予 n.拨款； 补助金； 授给物（如财产、授地、专有权、补助、拨款等） vi.同意
universal	adj. 普遍的,通用的,宇宙的 n. 通用
attendance	n. 出席,出席人数,出席率
intimate	adj. 亲密的,私人的,秘密的 n.  密友 vt. 透露,暗示
expect	vt.期望； 预料； 要求； 认为（某事）会发生 vi.预期； 期待； 怀胎； 怀孕
widespread	adj. 分布(或散布)广的,普遍的
experience	n. 经历, 经验 vt. 经历, 体验
greet	vt. 问候,致敬,欢迎,映入眼帘
partial	adj. 部分的,偏袒的,偏爱的 n. 泛音
investigate	vt. &vi. 调查,研究 [计算机] 研究
blowhole	n. 喷水孔, 通风孔, 通气孔
explosion	n. 爆炸,爆发,激增
defy	vt. 反抗,藐视,挑衅
interim	adj. 中间的,暂时的,临时的 n. 中间时期,过渡时期,暂定
extreme	adj. 极度的,极端的,尽头的,严重的,末端的 n. 极端,极限
sneeze	n. 喷嚏 vi. 打喷嚏
serial	n. 序列，串列 adj. 连续的，一连串的
wary	adj. 小心的,机警的,周到的
revival	n. 复兴, 复活, 恢复精神
assimilation	n. 同化, 同化作用, 消化
assist	n. 帮助,协助,协助的器械 vt. 帮助,协助 vi. 帮助,协助,出席
detective	adj. 侦探的 n. 侦探
certification	n. 证明, 保证, 鉴定
assistant	adj. 助理的；辅助的。 n. 助手助理；助教，店员
mine	pron.(I的所有格)我的（东西） n.矿； 矿井； 地雷； 水雷 vt.& vi.在…中开采，开采 vt.在…中[下]布雷； 以地雷[水雷]炸毁
extinction	n.熄灭； 消灭，灭绝； 废除； [物]消光，自屏，衰减
landscape	n. 风景,山水,风景画 v. 美化…的景观,进行造园工程
delay	n. 耽搁,迟滞 vt. 耽搁,延迟 vi. 耽搁
requirement	n. 要求,必要条件
delivery	n. 递送, 交付, 分娩
soluble	adj. 可溶解的，可解决的
resistant	adj. 抵抗的,反抗的 n. 抵抗者
mobile	adj. 可移动的,易变的,迁徙的, 流动的 n. (可随风飘动的)悬挂装置, 可动雕塑
respect	n. 尊敬, 敬重; 关系, 方面 vt. 尊敬, 尊重; 关于, 涉及
pressure	n. 压力, 压强, 压迫
permit	n. 许可证,执照 vt. &vi. 允许,许可
imaginative	adj. 富于想象力的
Mediterranean	adj. 地中海(的) n. 地中海
sensory	adj. 知觉的, 感觉的, 知觉器官的
bottom	n. 底部;臀部;船身;水底;服装下面的部分;低洼地;底色;尽头 adj. 底部的 vt. 给...装底,建立基础,到达底部 vi. 到达底部,垫底，降到最低点
restriction	n. 限制,约束 vi. 结果,(作为结果)发生
muted	adj. 1.（声音）静静的；减轻的；2.（意见）含糊不清的；表达不明确的
detract	vi. 减损  vt. 转移
irrelevant	adj. 不恰当的,无关系的,不相干的
consistent	adj. 始终如一的, 一致的, 坚持的
agenda	n. 议事日程
version	n. 版本, 说法，翻译
dialog	n. 对话, 对白 （美）=dialogue
eliminate	v. 除去,排除,剔除 [计算机] 消除
rewarding	adj. 有报酬的, 有益的
analytical	adj. 分析的,解析的,善于解析的
anonymous	adj. 匿名的,无名的,没特色的
calamity	n. 灾难, 不幸事件
prevalence	n. 传播, 流行, 普及
emphasize	v. 强调,着重 vt. 强调
finite	adj. 有限的
automatically	adj. 不经思索的 adv. 自动地
virtue	n. 美德,优点;贞操
visible	adj. 可见的, 看得见的
flexibility	n. 灵活性, 柔韧性，适应性
coordinate	n. 同等的人物; (色调, 图案, 样式等)配套服装 adj. 同等的, 等位的; (大学)男女分院制的 v. 协调, 整合; 使一致 [计算机] 坐标
labour	n. 劳动, 劳工 Labour (英国)工党
exploratory	adj. 勘探的，探索的
approximately	adv.近似地,大约
mediocre	adj. 平庸的, 平凡的
advisable	adj. 明智的,可取的
enforce	vt. 加强, 强迫, 执行
platform	n. 平台,月台,讲台,坛,计划
doctrine	n. 教义,主义,学说;[古]教学,指导,指令指示;军事战略
collaborate	vi. 合作,通敌
distant	adj. 遥远的,疏远的，远房的，陌生的，远行的
orbit	n.势力范围, 眼眶, 轨迹 vt. 绕轨道而行, 进入轨道 vi. 盘旋
enormous	adj. 巨大的, 庞大的
stability	n. 稳定性,居于修道院
stable	adj. 稳定的；牢固的；坚定的 n. 马厩；牛棚 vi. 被关在马厩 vt. 赶入马房
circumstance	n. 环境,(复数)境况,事件,详情
count	v. 计算, 视为, 依赖 n. 计数
documentation	n. 文件
paradox	n.反论，悖论； 似非而是的论点； 自相矛盾的人或事； [物]佯谬
indifferent	adj. 漠不关心的, 无重要性的, 中立的
differentiate	vt. 识别, 使差异, 求导数, 区分, 区别对待 vi. 区别,变异
provoke	vt. 激怒, 惹起, 驱使
transcription	n. 抄写，誊写，录音，编曲 [生]转移
exempt	n. 免税者,被免除义务者 adj. 免除的 v. 使免除
infect	vt. 传染,感染
equip	v. 装备, 设, 穿～
tremendous	adj. 巨大的, 惊人的
bias	n. 偏见，斜纹 vt. 使偏心
politician	n. 政治家, 政客
politics	n. 政治,政策,政治活动,政见
infinite	adj. 无限的,无穷的 n. 无限
pollution	n. 污染, 污染物
extravagant	adj. 奢侈的,浪费的,过度的,大量的
luxury	n. 奢侈, 豪华, 奢侈品
persist	vi. 坚持,固执,持续
hollow	n. 洞, 窟窿, 山谷 adj. 空的, 虚伪的, 空腹的 vt. 形成空洞, 挖空 vi. 形成空洞 adv. 有闷哑声, 完全地
static	n. 静电, 静电干扰, 噪声, 阻碍, 抨击 adj. 静态的,静电的,固态的
evaluate	vt. 评估,评价
confirmation	n. 确认, 证实, 基督教的坚信礼
vindicative	adj. 辩护的, 辩明的
weary	adj. 疲倦的,厌烦的 vt.& vi. 疲倦,厌烦,生厌
inquire	vt. 询问,查究 vi. 询问,查究
notion	n. 观念,想法,主张
emergent	adj. 出现的,紧急的，新兴的
reason	n. 理由,原因,理智,理性 vt. 说服,总结 vi. 规劝,下判断
post	n. 邮件, 标竿, 职位 vt. 邮递, 发布, 布置
distinctive	adj. 有特色的,出众的
conviction	n. 定罪, 信服, 坚信
cooperative	adj. 合作的,共同的 n. 合作社
spectacular	adj. 壮观的, 令人惊叹的 n. 惊人之举, 壮观的表演或影视作品
descendent	adj. 下降的, 降落的, 世袭的 n. 后代，子孙 =descendant
ridicule	n. 嘲笑, 愚弄, 笑柄 v. 嘲笑, 嘲弄, 愚弄
falter	v. 支吾地说,迟疑,蹒跚地走
bizarre	adj. 奇异的,怪诞的 n. 奇异花
mathematical	adj. 数学的，精确的，可能性极小的
defective	adj. 有缺陷的,欠缺,不完全变化动词 n. 有缺陷的人,不完全变化动词
divisible	adj. 可分的, 可割的,【数】可以除的
advantage	n. 优势,有利条件 vt. 有利于
morale	n. 道德准则,士气,斗志
demonstrate	vt. 示范, 演示, 证明 vi. 示威
curve	n. 曲线,弯曲,曲球 vt. 使...弯曲 vi.弯曲
excessive	adj. 过多的,过分的
reflect	v. 反映, 反射, 归咎
reflection	n. 反映,映像,折射,沉思,影响
sample	n. 样品,标本 vt. 采样,品尝 adj. 样例的
storage	n. 储存体, 储藏, 仓库, 保管费
drain	n. 下水道,排水沟,消耗 vt. 耗尽,排出,排干,喝光 vi. 变干,排出,排水
sequent	adj. 继续的, 相随的 n. 结果，随之而来的事
redundant	adj. 多余的,失业的
fluctuate	vi. 变动, 上下, 动摇 vt. 使动摇
regarding	prep. 关于, 至于
exhaust	n. 排气,排气装置 v. 用尽,耗尽,使...精疲力尽 [计算机] 排除
marked	adj. 有记号的,显著的,醒目的 v. 作记号,打分数,表示 vbl. 作记号,打分数,表示
integrity	n. 诚实, 正直, 完整, 完善
tolerate	v. 忍受,容忍,容许,宽恕 vt. 容忍,忍受,容许
vegetarian	n. 素食者 adj. 素食的
deplete	vt. 耗尽,使...空竭
experimental	adj. 实验(性)的, 试验(性)的
scene	n. 场,景,情景
species	n. [生物] 物种；种类 adj. 物种上的
erupt	v. 爆发
prove	v. 证明, 查验, 显示
relevant	adj. 相关的, 切题的, 中肯的
nevertheless	adv. 仍然, 不过 conj. 然而, 不过
justice	n.正义； 公正； 法律制裁； 审判员，法官
framework	n. 结构, 框架, 参照标准, 体系
pessimist	n. 悲观主义者
neural	adj. 神经的
patent	n. 专利权,执照,专利品 adj. 专利的,显著的,新奇的 v. 取得...的专利权,请准专利
objective	adj. 客观的, 目标的 n. 目标, 目的; 物镜 n. =objective case 宾语
dismay	n. 沮丧, 绝望 vt. 使...灰心,使...惊愕
liquid	adj. 液体的, 液态的 n. 液体
relieved	adj. 感到宽慰的；放心的；显得开心的
essence	n. 本质,精髓,要素,香精
substitute	n. 代替者,代用品 v. 代替 vi. (for)代替 vt. 用...代替,代以
compete	v. 竞争, 对抗
credible	adj. 可信的, 可靠的
successful	adj. 成功的,达到目的的
detain	vt. 扣留,拘押,耽搁
vicinity	n. 邻近,周边地区
diffuse	vt. 散播,使(气体或液体)慢慢混合 vi. 弥漫,扩散 adj. 冗长的,四散的,散漫的
similarity	n. 相似, 类似
composition	n. 作文,著作,组织,合成物，成份
presumption	n. 推测, 可能性，冒昧，放肆，[法律]推定
comparative	adj. 比较的,相当的 n. 对手
astronaut	n. 宇航员
unbiased	adj. 公正的
ample	adj. 充足的,丰富的,宽敞的
budget	n. 预算 vt. 编预算,为…做预算 vi. 节省开支 adj. 不贵的，廉价的
blow	n. 吹；打击；殴打 vi. 风吹；喘气 vt. 风吹
declare	vt. &vi. 宣布,声明,申报
junior	adj.较年幼的，较年小的； 三年级的，低年级的； 资历较浅的； 后进的 n.年少者，青少年； 晚辈； 三年级生； 职位较低者
condemn	vt. 判刑, 谴责, 官方宣称（某事物）有缺陷或不宜使用
resident	adj. 居住的 n. 居民,旅客
furthermore	adv. 而且, 此外
athletic	adj. 运动的,活跃的,健壮的
performance	n.表演； 演技； 表现； 执行
confuse	vt. 混乱,狼狈,困惑
editor	n. 编辑, 编者
immature	adj. 不成熟的
vacant	adj. 空的,空虚的,木然的